+-+-+-+-+-+-+-+-+-+-+
|   |   | | |   | | |
+ +-+ +-+ + + +-+ + +
|     | | | |   |   |
+ + + + + + + +-+ + +
| | |         | | | |
+-+-+ +-+-+ +-+ +-+ +
|   |   |   | | |   |
+-+ + +-+ +-+ + + +-+
| | | | | | |       |
+ + + + + + +-+ + +-+
| | |   |       | | |
+ + +-+ +-+ +-+ +-+ +
|   | | | |   |   | |
+-+ + + + + +-+ + + +
|   |     |   | | | |
+ + + + +-+ +-+ + + +
| | | | | | | | | | |
+ + + +-+ + + +-+ + +
| |       |     |   |
+-+-+-+-+-+-+-+-+-+-+