+-+-+-+-+-+-+-+-+-+-+-+-+-+-+-+-+-+-+-+-+
| |       |         |     | | | |   | | |
+ +-+-+ +-+-+ +-+ + + + +-+ + + +-+ + + +
|   | |       |   |   |   |     | | |   |
+-+ + + +-+ + +-+ + + + +-+-+ +-+ + + +-+
|         | | | | | |   |   |   |     | |
+-+-+ +-+ +-+ + +-+ + +-+ + + + +-+ +-+ +
|   |   |   |   | | |     |   | | | | | |
+-+ + + +-+-+ + + +-+-+ + +-+ + + + + + +
| | | | |   | | |   | | | | | |     | | |
+ + + +-+ +-+-+ + +-+ +-+ + +-+ + +-+ + +
| | | | | |   |     |   |     | |   | | |
+ + + + + +-+ + + + + + + +-+ + +-+-+ + +
|         |     | | | |     | | |   |   |
+-+ +-+-+-+-+ + + + +-+-+-+ +-+-+-+ + +-+
|   |   | |   | | | |   |               |
+-+ +-+ + +-+ +-+-+ +-+ + +-+-+ +-+ +-+ +
|   |   | | |     |   |   |   |   | | | |
+ +-+-+ + + +-+-+ +-+-+ +-+ + + +-+-+ + +
| | | |           | |   |   | |     |   |
+ + + +-+ +-+ + +-+ +-+ +-+ + +-+-+-+ + +
| |   |     | |     |     | | | | | | | |
+ + +-+ +-+ + +-+-+-+-+ + + +-+ + + + +-+
| | |     | | | | | |   | | |     | | | |
+ + +-+-+ +-+ + + + +-+-+ + +-+ +-+ + + +
| | | | | |   |   | | |     | |     |   |
+ + + + +-+ + + + + + +-+-+ + + +-+-+-+ +
|   | |   | |   | |   |     | | | | |   |
+-+ + + +-+-+-+ +-+ + + + +-+ + + + + +-+
|   | |     |       | | |   | |         |
+ + + + + +-+-+-+-+ + +-+-+ + +-+-+-+-+ +
| | | | | | |       | |             |   |
+-+ + + + + +-+ +-+ +-+ + +-+-+ +-+ +-+ +
|         | |   |   | | |     | | |   | |
+ +-+ + +-+ +-+-+ +-+ +-+-+-+ + + +-+-+ +
|   | | |     |     | | |     | | | |   |
+-+ + +-+-+ +-+ + + + + +-+-+ + + + + + +
| | | | | | |   | | |       | | | | | | |
+ +-+ + + + +-+-+ + + +-+-+-+ +-+ + + + +
|               | |         |       | | |
+-+-+-+-+-+-+-+-+-+-+-+-+-+-+-+-+-+-+-+-+