+-+-+-+-+-+-+-+-+-+-+-+-+-+-+-+-+-+-+-+-+-+-+-+-+-+-+-+-+-+-+
|     | | |   |     | |   |     | |   | | | |   | |         |
+ +-+-+ + + +-+ +-+-+ + +-+ +-+ + +-+ + + + + +-+ + + +-+-+-+
| |   |   | | | | | | |   |   | | |   | |   | |     | |   | |
+ + +-+ +-+ + + + + + +-+ + + +-+ +-+ + +-+ + +-+ + +-+-+ + +
|             | |           |     |   |   |   |   |   |   | |
+ +-+ + +-+ + + + +-+-+-+ +-+-+-+-+ +-+ +-+-+ +-+ + + + +-+ +
|   | |   | | | | |     |     |   | | |   | | |   | |   |   |
+ + + +-+-+ +-+ + +-+-+ +-+-+ +-+ + + +-+ + + +-+ +-+ + +-+ +
| | |   | |   |   | |   |     |         |   | |   | | | | | |
+-+-+-+ + + + +-+ + +-+ +-+ +-+-+-+-+-+ +-+ + +-+ + + +-+ + +
|   | | | | |   |       |   |   | | | |   |   | |   | | | | |
+ +-+ + + + + +-+ +-+-+-+ +-+ + + + + + +-+ +-+ + +-+ + + + +
|   |     | |   | | | | | | | | | |   |   |     | | | |   | |
+-+ + +-+ + +-+-+ + + + + + + + + +-+ +-+ + + + + + + +-+ + +
| |     | | |       |   | | | |     |       | |     | | | | |
+ +-+ + +-+-+-+ +-+ +-+ + + +-+-+ +-+-+-+-+ + + + + + + + + +
| |   |   |   | |   | | |   |   | |   |     | | | | | | |   |
+ + +-+ + +-+ +-+ +-+ + + + + +-+ +-+ +-+ + +-+ +-+-+-+ + + +
|     | | |   | |       | |   |   |   |   |   |   |   |   | |
+-+ + + +-+ +-+ +-+ +-+-+-+ + +-+ + +-+-+ + +-+-+ + + + + + +
|   | |   |   | | | | |   | |   |       | |   | |   | | | | |
+-+ + +-+-+ +-+ + + + + + + +-+-+-+-+-+ +-+ +-+ + + + + +-+-+
| | | |   |   | |   | | | |   |     |   | |     | | | |   | |
+ + +-+ + +-+ + + + + +-+ +-+ +-+ +-+-+ + +-+ + + +-+-+ + + +
|   |   |   | |   |         |         |   |   | |   | | | | |
+ +-+ +-+-+-+ + +-+ + +-+-+ +-+-+-+-+-+ +-+-+-+ + + + + +-+ +
|     |   |       | | |   |   |   |   |   |   | | | |   |   |
+ +-+ +-+ +-+ + + + + +-+ +-+ +-+ + +-+-+ + + + +-+-+ + + +-+
|   | |   |   | | | |   | | | |       | |   |   | |   |     |
+ + + +-+ +-+ +-+ +-+ + + + + + + +-+ + +-+-+-+ + +-+ +-+-+ +
| | |     |   |     | | | |     | | |         |         |   |
+-+-+-+ + + + + +-+-+ +-+ + + +-+-+ +-+-+-+ + +-+-+-+ + +-+ +
|   |   |   | | |   | | |   |   |   |   | | | |   | | |   | |
+-+ +-+-+ + + + + +-+ + +-+-+-+ +-+ + + + +-+ +-+ + + +-+-+-+
|   |     | | | | |       |     | | | | | |       | |       |
+-+ + + +-+-+ +-+ +-+-+-+-+ + + + + +-+ + +-+-+-+ + +-+-+-+ +
| |   |   |     |   | | | | | | |         | | |   |   | | | |
+ +-+ +-+ +-+ +-+-+ + + + +-+ +-+ +-+-+ + + + +-+ +-+ + + + +
| | | | | |   | | | |   | |       | | | |   | |   | |   | | |
+ + + + + + +-+ + + +-+ + +-+-+ + + + +-+-+ + + + + +-+ + + +
| | |   | |     |   |   | | | | |   | |     |   | | |   |   |
+ + +-+-+ +-+-+-+ + + +-+ + + + + + + +-+ +-+ + +-+ +-+ +-+ +
|   |   |   |     | |   |   |   | |   |     | | |       | | |
+-+ +-+ + +-+-+ +-+ +-+ +-+ +-+-+ +-+ + +-+-+-+-+ +-+-+-+ + +
| | | |   |   | |     |   | |   | |   | |         |     |   |
+ + + +-+ + +-+-+-+ + + + + + +-+-+-+-+ +-+ + +-+-+-+ +-+ + +
|         |   | | | | | |   | |   | |   | | |         |   | |
+-+-+-+-+ +-+ + + + + + +-+-+ +-+ + + +-+ + +-+ +-+-+-+ +-+ +
|   |           |   | | |     | |     | | |   | |   | | | | |
+-+ +-+-+-+ + +-+ +-+ + + + +-+ + +-+-+ + + + + +-+ + + + + +
|   | | |   |   |   | |   |   |   |   |     | | |   | |   | |
+ +-+ + +-+-+ +-+ +-+ +-+ +-+-+-+ + + +-+ +-+ +-+ + + + +-+-+
|       |     | | |   |   |     | | | |   | |     | | |   | |
+-+ + + +-+ +-+ +-+ +-+-+ + + + + +-+ + +-+ + +-+-+ + +-+ + +
| | | | |     |   | | | | | | | |         |   | | | |   |   |
+ + +-+ + + + + +-+ + + + +-+ +-+ +-+-+-+ + +-+ + + +-+ +-+ +
| | |   | | | | |   |   | | |   | | |   | | |     |       | |
+ + +-+-+ +-+-+ +-+ + +-+ + + + + + + + + +-+ + + +-+-+ +-+ +
|                           | |     | |       | |     |     |
+-+-+-+-+-+-+-+-+-+-+-+-+-+-+-+-+-+-+-+-+-+-+-+-+-+-+-+-+-+-+