+-+-+-+-+-+-+-+-+-+-+-+-+-+-+-+-+-+-+-+-+-+-+-+-+-+-+-+-+-+-+-+-+-+-+-+-+-+-+-+-+
| | |   | |   |   |     |       | | | | |   |       | |       |         | |     |
+ + +-+ + + +-+ +-+-+ + +-+ +-+-+ + + + + +-+ +-+ + + + + +-+ +-+ +-+-+-+ + +-+-+
| |       |     | |   |       |   | | |   |   | | |   | | | | | |     |     | | |
+ +-+-+ +-+-+ +-+ + +-+ + + + +-+ + + +-+ + + + +-+-+ +-+ + + + + + + + +-+ + + +
| |   | | | | |   |   | | | | |   |   |   | |   |   |   |   |     | | |   | |   |
+ +-+ + + + + +-+ + + +-+-+ + + + +-+ +-+ + +-+ +-+ +-+ + +-+-+-+ +-+-+ + + + +-+
| | | | |   |   |   |     | |   | |   | | |   | | | |   | |   | | | |   | | | | |
+ + + + + + + +-+-+-+ + + + + +-+ +-+ + + +-+-+ + + + +-+ + + + + + + +-+-+ + + +
| |       |   |       | | | |   | |   | | | |   |     | | | | |   | |   | |   | |
+ + + + + + + +-+ +-+-+ +-+ +-+ +-+-+ + + + +-+-+ +-+ + + +-+ + + + + + + + +-+ +
| | | | | | | |   |   | | |   |     | |   | |     |   | |     | | |   | |     | |
+ +-+-+ +-+ +-+ + + + + + + + + + +-+ +-+ + + +-+-+-+-+ +-+-+-+-+ + +-+ +-+-+-+ +
| |     | |   | |   | | |   | | |       | | |   |     | | |   |   | |   |   | | |
+ +-+ + + + +-+ +-+-+-+ +-+ +-+ + + +-+-+ + +-+ +-+ + + + + +-+ + +-+ + + + + + +
| |   | | | | | | | |     | |   | | |   |   |       |   | | |   | | | | | | | | |
+ +-+ + + + + + + + + + +-+ + +-+-+-+-+ + +-+ + +-+-+ +-+ + + +-+-+ + +-+ + + + +
| | | |   |   |     | |   | | | |       | | | |   | | | | |   | | | |   | |   | |
+ + +-+ + + +-+ + +-+-+ + +-+-+ +-+-+-+ + + + +-+-+ + + + + + + + + + +-+-+ +-+ +
| | | | | | |   | | | | | | |   | | | |     |       | | | | |   | |   | | | |   |
+ + + + + +-+ + + + + + + + + +-+ + + + + +-+-+-+ +-+ + + + + +-+ +-+ + + + +-+ +
|   |   |     | | | | | |   |     | |   | | |   | |         |   |   |     |   | |
+-+ + +-+-+ + +-+-+ + +-+-+ +-+ + + +-+ + + + + + +-+-+ + + +-+ +-+ + +-+ +-+ + +
|   |     | |   |   | | |       | |     | | | |       | | | | |         |   | | |
+ + +-+ +-+ + +-+ +-+ + +-+-+ +-+-+-+ +-+-+ + + + + +-+-+-+-+ + +-+-+-+ +-+-+ + +
| | | | | | |     | | |   |   |   | |     |   | | | | |   |     |     | |       |
+ + + + + + +-+-+-+ + + +-+-+ + +-+ + + + +-+ + +-+ + + +-+-+ + + + + + + +-+ +-+
| |             |   | | |       |     | |   | |   |     | |   | | | | |     | | |
+ +-+-+-+-+-+ +-+ +-+ + +-+ +-+ +-+ + +-+ + +-+-+ + +-+-+ +-+ +-+ +-+ + + + +-+ +
| |   |   | |   | | | | | |   |     | |   |           |   |       | |   | |     |
+ + + + + + +-+ + + + + + + +-+-+ + +-+-+-+ + + +-+ +-+-+ + + + + + +-+ + + +-+-+
|   |   |     |   |   | | |   |   |     | | | | |   |       | | |   |   | | |   |
+-+ + +-+ +-+-+-+-+ + + + + +-+-+ + +-+ + +-+ + + +-+-+-+ + +-+ + + + + +-+ +-+ +
| | |   | | |   |   |   |   |   | | | | |     | |   | | | | |   | | | |   |     |
+ + + + +-+ +-+ +-+ + + +-+ +-+ +-+ + + +-+-+-+-+-+ + + + +-+-+ +-+ + +-+ + + + +
| | | |     |   | | | | |   |   |   |   |     |       | | |       | | | | | | | |
+ + +-+-+-+-+ +-+ + + +-+-+ + + + +-+-+ + + +-+-+ + + + +-+-+-+-+-+-+ + + + +-+-+
| | |   |           |     | | |   |       |   | | | |   |     |     |   | | |   |
+ + + + + + + +-+ + + +-+ + + + +-+ +-+-+-+-+-+ +-+-+ +-+-+-+ + + +-+ +-+-+-+ +-+
|     |   | |   | |   |   | | |   |           |             |   |               |
+-+-+-+-+-+-+-+-+-+-+-+-+-+-+-+-+-+-+-+-+-+-+-+-+-+-+-+-+-+-+-+-+-+-+-+-+-+-+-+-+