+-+-+-+-+-+-+-+-+-+-+-+-+-+-+-+-+-+-+-+-+-+-+-+-+-+-+-+-+-+-+
|   |   | | |       |     | |         |       |   |   |   | |
+ +-+-+ + + +-+ +-+-+ + + + +-+ +-+-+-+ + +-+-+ +-+-+ + +-+ +
| |     |   |   | |   | |         | |   | | |       | |     |
+ +-+-+ + +-+ + + +-+-+-+ +-+-+-+ + +-+-+ + + +-+-+-+ +-+ +-+
|     |   | | |             | | |   |     | |             | |
+ +-+-+ + + +-+ + + +-+ +-+ + + + + +-+ +-+ +-+ +-+-+ +-+-+ +
| |     |   | | | | | |   |     | |   |   |         | | | | |
+ +-+ + + + + +-+-+ + + + + + +-+ +-+-+-+ + + +-+ +-+ + + + +
|   | | | | | |   | |   | | |   |   |     | | |     |     | |
+-+ +-+-+ +-+ + +-+ + +-+ +-+ + +-+ + +-+ +-+ + + + +-+ + + +
|     | | | |     | |   | |   |   | |   |   | | | |   | |   |
+-+ + + + + + +-+ +-+-+ + +-+ + + + +-+ + + +-+-+-+-+ +-+-+ +
|   |   |   |   | | |   |   | | | | |   | |   | | | | |   | |
+ +-+ +-+ + + + + + + + +-+ + +-+-+-+ + +-+-+ + + + + +-+ + +
| |     | |   | |   | |   | |   |   | |   | | | | |   |     |
+-+ + +-+-+ +-+ +-+ +-+ +-+-+ +-+-+ +-+-+ + + + + +-+ + + + +
| | |   |   |     | | | | | | | |   |     |     |   | | | | |
+ +-+-+ + +-+-+ + +-+ + + + + + + +-+ + +-+ + +-+ +-+-+-+-+ +
|         |     |           |         |     |               |
+-+-+-+-+-+-+-+-+-+-+-+-+-+-+-+-+-+-+-+-+-+-+-+-+-+-+-+-+-+-+