+-+-+-+-+-+-+-+-+-+-+-+-+-+-+-+-+-+-+-+-+-+-+-+-+-+-+-+-+-+-+-+-+-+-+-+-+-+-+-+-+-+-+-+-+-+-+-+-+-+-+-+-+-+-+-+-+-+-+-+-+
|       | | | | |     |           | |   | |     | | |         | | | |   |     |   |         |     | |     |   |   | | | |
+-+ +-+ + + + + + +-+-+-+-+-+-+-+ + +-+ + +-+ +-+ + +-+-+ + +-+ + + + +-+ +-+-+-+ +-+ + +-+-+-+ +-+ + +-+ +-+ + + + + + +
| |   | |   | | | |       | |     |   | | |   |   |       |   | |     | | |   |   | | |     |   |     |   | | | | | | | |
+ + +-+ + +-+ + + + + +-+-+ + +-+ + +-+ + + +-+-+ +-+-+-+ +-+ + + +-+ + + + +-+-+ + + + + + +-+ +-+-+ + +-+ + + +-+ + + +
|     | |         | |   |     | |         |     |   | |   | |   | | | | | |   |     | | | | |     |   | |   | |       | |
+ + + +-+ + +-+ +-+-+ + +-+-+ + +-+ + + + +-+ +-+-+ + +-+ + +-+ + + + + + + +-+-+ +-+ +-+ + +-+ +-+ +-+ +-+ + +-+ +-+ + +
| | | |   | | |   |   | | | | | | | | | |   | | | | | | | |         | |       |   |   |   | | |   |   |       | |   |   |
+-+-+ +-+-+ + + +-+-+-+ + + + + + +-+-+-+-+ + + + + + + +-+ + +-+-+-+-+-+-+ +-+ + +-+-+-+-+ + +-+ + +-+-+ + +-+ + + +-+ +
|   | | | | | | |     |           |       |   |   | | |     | |   |   | |   |   |     |   |   |   |   | | |   | | |   | |
+ + + + + + + + +-+ + + + + +-+-+-+-+-+ + +-+ +-+ + + +-+ +-+ + + +-+ + +-+ +-+-+ +-+ +-+ +-+ + +-+ +-+ + + + + + +-+-+-+
| | |     |   |   | |   | | | | | | |   |     |   |     |   |   | | |       |   | |       |   | | | |     | | |   |   | |
+ +-+ + +-+-+-+-+ +-+ + + +-+ + + + + + + + +-+-+ + +-+-+-+-+-+-+ + +-+ + +-+-+ +-+ + + + + + + + + +-+-+ + +-+-+ +-+ + +
|   | | | |         | | |     |   | | | | |   |         |   |           | |       | | | | | | |   | |   | |   | | |   | |
+-+ + +-+ +-+ + +-+ + + + +-+-+-+ + + + + + +-+-+ +-+ + +-+ +-+ + + + + + + + +-+ +-+ + + + + +-+ + + +-+ +-+ + + +-+ + +
|   |   | |   |   | | | | | | |   |   | | |         | |         | | | | |   |   |   | | |     | |   |   |   | |   | |   |
+-+ +-+ + + +-+-+ +-+-+-+ + + + +-+-+-+ + +-+-+-+-+ +-+-+-+-+-+ +-+-+ +-+-+-+-+ + +-+-+-+ + + + +-+ +-+ + +-+-+ + + +-+ +
| | |           |   | |             | | |   |               |   |   |   | |   | | |     | | | |     |         | | |     |
+ + +-+ + + + + +-+ + +-+ + + +-+ + + +-+ + +-+-+ +-+-+ +-+-+ + + +-+-+ + + + + +-+-+-+ +-+-+ + + +-+ +-+ + +-+-+ +-+-+ +
|   | | | | | | |       | | | |   |     | | |   | | | |     | |       |     | |   |   | |   |   | |   |   | |         | |
+ + + + + + +-+ + + + +-+-+-+ +-+-+ + + + + + + + + + + + + +-+-+-+ +-+ + +-+ +-+-+-+ + +-+ + +-+-+-+ + +-+ +-+ +-+ + + +
| | | | | | |   | | |   |         | | | | |   | | |     | |     | | | | |   | |       | |   | | |     | |       | | | | |
+-+ + +-+ + + + + +-+-+ + + +-+-+ +-+ + +-+-+-+ + + +-+ + +-+-+-+ + + +-+-+-+ + +-+-+-+ + +-+ + +-+ +-+ + + + + + + +-+ +
| |       | | | | | | |   | |   | |   |       | | |   | | |     | |   | | |   |     |   | | |     |   | | | | | |   |   |
+ + +-+-+ + +-+-+-+ + + + +-+ +-+ + + + +-+-+ + + + +-+ +-+-+-+ + +-+ + + + +-+-+ + + +-+ + + +-+-+ +-+ + +-+ + + + + + +
| |     | | | |   |   | |   |   | | | |     | | | | | |   |     |   |     | |     |   |       | |   | | |   | | | | | | |
+ +-+ + +-+ + +-+ +-+ +-+-+ + + +-+-+-+ + + +-+-+-+-+ + +-+-+ + +-+ + + +-+ + +-+ + + + +-+ + + + +-+ + + + +-+-+ +-+ + +
| |   |   | | |       |       |   | |   | |         | |   |   |       | | | |   | | | |   | |   |   |   | |   | |   | | |
+ + + + + + + + +-+ +-+ +-+-+-+ +-+ + + + +-+ +-+-+ + +-+ + +-+ + +-+ +-+ + + + +-+ + + + +-+-+-+ + +-+ +-+ + + +-+ +-+ +
|   | | | |   | |     |     | | |   | | |   |   |   | |   | |   |   | | |   | | | | | | |       | |   | |   |   |   |   |
+ + + + +-+ +-+-+-+ + +-+ + + + + + + +-+ + +-+ + +-+ +-+ +-+ +-+ + +-+ + + +-+ + + +-+ +-+-+ +-+ + +-+-+ +-+ +-+-+-+ +-+
| | | |   |         | |   | |   | | | |   | | | | |   | | |   | | |   | | | |   |       | | |   | |     | |       | | | |
+ + + +-+-+ +-+ + + + +-+ + + + +-+ +-+-+ + + +-+ + + + +-+ +-+ + + +-+ +-+ + +-+ + +-+ + + +-+ +-+ +-+-+ +-+ +-+ + + + +
| | | |     | | | | |   | | | | | |   |   | |       |     | |     | | |   |       | |     | |     |   |   | | |   |   | |
+-+-+-+-+-+ + + + + +-+ + +-+ +-+ +-+ + + + +-+-+ + + + + + + +-+ +-+ + +-+-+ +-+-+ + +-+-+ +-+-+-+ +-+ +-+ + +-+-+ +-+ +
|             | | |   | |   |         | | | | | | | | | | | | |   |   |     |     | | | |   |   |     |   |   | |       |
+-+-+-+ +-+-+-+ + + + +-+ +-+-+-+-+ + +-+-+-+ + + + +-+-+-+ + + + +-+ +-+ +-+-+-+ + +-+ + +-+-+ +-+ + + +-+-+-+ +-+ + + +
| | | | | |   | | | |   | |   | | | |   |   |   | |   |   | | | | |         |     | |   | |         | | | | | |     | | |
+ + + + + + + +-+ +-+ + + +-+ + + +-+-+ + + +-+ + +-+ +-+ +-+ + + +-+ +-+ + + + + +-+ +-+ +-+ + +-+-+-+-+ + + + +-+-+-+-+
| | | |   | |   | |   | | |         |   | |   | | | |   |     | | |   |   |   | | | |     |   |   | | | | | | |     | | |
+ + + +-+ + + +-+-+ +-+-+ +-+ + + + +-+ + + + + + + +-+-+-+ + +-+-+-+ +-+ + +-+-+-+ +-+ + + + + + + + + + + + + + +-+ + +
| |   | |     | |     | |     | | |   |     |   | | | | | | |     | |   | |   |       | |   | | | | | | |   |   |     | |
+ +-+ + +-+ + + +-+ +-+ +-+ +-+ +-+ +-+-+-+ +-+-+-+ + + + + + +-+-+ + + + +-+ +-+ + +-+-+ + +-+ +-+ + + +-+ + + + +-+-+ +
|   |   | | |     | | | |   | |   |   | |   | |       | |   |   | | | | | | |     | |     | | | |       |     | | |   | |
+-+ + + + + + +-+ +-+ + +-+ + + + +-+-+ +-+ + + +-+ + + +-+ +-+-+ + +-+ +-+ +-+ +-+-+ + +-+ + + + +-+ + + +-+ +-+-+ + + +
| | | |   | | |   | | | |   |   |         |     | | |     |     |     | | | |       | | |   | | | |   | | |         | | |
+ + + +-+-+-+-+ + + + + +-+-+ +-+-+-+-+ +-+ + + + +-+-+ +-+ +-+ +-+ +-+ + + + + +-+ +-+-+ +-+ + + + + + + + +-+-+-+ + + +
| | | |         |     | |   |   |   | |   | | | |     | | |   | |   |     |   |   |   | |   | |   | | |   | |   | |     |
+ + + + +-+-+ + + +-+ + +-+ + +-+-+ + + +-+-+-+ +-+ + + + +-+ + + + + +-+ +-+-+-+ + + + + +-+ +-+-+-+-+ +-+-+ +-+ + +-+-+
| | | | | | | | |   |   | | |     | |     |     |   |   |     | | |     |   | | | | | | |         |   |       | |     | |
+ + + + + + + +-+-+ + +-+ + + +-+ + + + +-+ +-+ +-+-+-+ + +-+-+ + + + + +-+-+ + + + +-+ +-+-+ +-+-+-+ + +-+ + + +-+ +-+ +
| | | | | | |   | | | |       | | |   | | | |   |   |   | | |   | | | | |   | |   |         |   |       | | |     | |   |
+ + + + + + + + + + +-+ +-+ + + +-+-+ +-+ + +-+ +-+ + + +-+ +-+ + +-+-+ + +-+ +-+ +-+ +-+-+-+ + + +-+-+ + + +-+ +-+ +-+ +
|   | |   |   | |     | | | | |     |     | | |     | | |   | | |   | | |       | |     | |   | |     |   | |     |   | |
+-+ + +-+ + +-+-+-+ + +-+ + +-+-+-+ + +-+ + + +-+-+ +-+ +-+ + + +-+ + + + +-+ + + + +-+-+ + +-+ + + + + +-+ +-+-+-+-+-+ +
|     | | |   | | | | | | |     | |     | | | |   | |         | |   |       | | | | |         | | | | | | |   |   |   | |
+-+-+ + +-+-+ + + + +-+ + + +-+-+ + + +-+-+-+ + + +-+ + + +-+-+ +-+-+ +-+-+-+-+ +-+-+-+ + +-+ + + +-+ + + +-+ + + +-+ + +
|       |       |       |   |     | | |   | |   | | | | | | | | |     | |     | | |   | | |   | | | | | | |     |   |   |
+ +-+-+-+-+-+ +-+-+ + + +-+-+ +-+ +-+ +-+ + +-+ + + +-+ + + + + +-+-+ + + +-+-+ + +-+ + +-+-+ +-+-+ +-+ + + +-+ +-+ + +-+
|                 | | |       |     |               |   |   |       |         |     |       |         |   |   |   |     |
+-+-+-+-+-+-+-+-+-+-+-+-+-+-+-+-+-+-+-+-+-+-+-+-+-+-+-+-+-+-+-+-+-+-+-+-+-+-+-+-+-+-+-+-+-+-+-+-+-+-+-+-+-+-+-+-+-+-+-+-+