+-+-+-+-+-+-+-+-+-+-+-+-+-+-+-+-+-+-+-+-+-+-+-+-+-+-+-+-+-+-+-+-+-+-+-+-+-+-+-+-+-+-+-+-+-+-+-+-+-+-+
|             |   | |   | |     | |   | | |     | |       | |   |   |   |     |   | |         |     |
+ +-+ +-+ +-+ +-+ + +-+ + +-+ +-+ +-+ + + +-+ + + + + + +-+ + + + +-+-+ + + +-+-+ + + +-+ +-+ + +-+-+
| | |   |   | | | |         |   | |   |     | | | | | | |   | |       |   | |       | |     |   | | |
+ + +-+-+ + +-+ + +-+ + + + + +-+ + + + +-+-+ +-+ + +-+-+-+ + + +-+-+ +-+ +-+-+-+-+ +-+-+ +-+-+-+ + +
|   |   | |     | | | | | |   |   | | | |   |       | |   | | | |   |             |         | | |   |
+ +-+ + + +-+ + + + + +-+-+-+ + + +-+ + +-+ + +-+ + + + +-+ + + + +-+-+ + + +-+-+ +-+-+ +-+-+ + + +-+
| | | |     | | |     | |     | |   | | | |     | | |       | |       | | | |     |   | | |   |     |
+ + +-+ +-+ + +-+-+-+ + +-+ +-+-+-+ + + + + +-+ + +-+-+ + +-+-+-+ + + +-+-+-+ + + +-+ + + + + + +-+ +
|   |   |   | |   |     | | |           |     | | |     |       | | | | | |   | | | |     | | | |   |
+-+ + + +-+ +-+ +-+ + + + + + +-+-+-+ + + + + + +-+-+-+-+ + + + + +-+ + + + + + +-+ +-+ +-+ +-+-+ +-+
| | | |   |   | | | | |   | | |   |   |   | | |   |   |   | | |     |     | | |   | |     | |     | |
+ + + + +-+-+-+ + + + +-+ +-+ +-+ + + +-+ +-+-+-+-+-+ + +-+-+-+-+-+-+-+-+-+ +-+ + + + + + + +-+-+ + +
|   | |   |     |   | | | |     | | |   |   |   | | | |   | | |         |   | | | |   | | | | | |   |
+-+ +-+-+ +-+-+ +-+ + + + +-+-+ + + + + + + + + + + + + + + + + + + +-+-+-+ + + + + +-+ +-+ + + +-+ +
| |     |   | |     |   |   | | | | | | | | | |     |   |       | |       |   | | | | |         |   |
+ +-+ +-+-+ + + +-+-+ +-+ + + + + +-+ + +-+ +-+-+ + +-+-+ +-+-+ + +-+ +-+ + + +-+ + + +-+ +-+-+-+-+ +
| |       |         |   | |       | | |   | |   | | |     |   | |   |   | | | |       |       |     |
+ + + + +-+ +-+-+ + +-+ +-+ + + + + + + +-+ +-+ +-+ +-+-+ +-+ + + +-+ +-+ + +-+ +-+ +-+-+ +-+-+-+ + +
|   | |   |     | | |   |   | | |   | |   |     |     |   | | | | | | |   |   | | |   |         | | |
+ +-+-+-+-+-+-+ + + + + + +-+-+ + +-+ + + + +-+ +-+-+ +-+ + + +-+ + + +-+ + + +-+ +-+-+ +-+ +-+-+-+ +
| | | | |   | | | | | | |   |   |   | | | |   | | | |   | | | | | |   | | | | |       | | | |   | | |
+ + + + +-+ + +-+-+ + + +-+ +-+-+ + + + +-+-+-+-+ + +-+ + + + + + +-+-+ +-+ +-+-+ + + + + + +-+ + + +
|   |       |   | | | |   |     | | | |   | |   |           | | | |     |     |   | |   |     | |   |
+-+ +-+-+-+ + + + +-+ +-+-+-+ + + + + +-+-+ +-+ + +-+ +-+ +-+ + + +-+-+ +-+-+-+-+ + + + +-+ + + + + +
| | | |       | | |   | |     | | | | |         |   | |     |             |     | | | | | | |     | |
+ + + +-+ + +-+-+ + +-+ +-+ +-+-+-+-+-+-+ +-+-+ +-+-+-+-+-+ +-+-+ +-+-+-+ + + +-+-+ + + + +-+ + +-+-+
| |     | | |             |       | | | |   |   | | |   |   | |     |   | | | | | | | | | | | | | | |
+ + + +-+-+ + +-+-+-+-+-+ + +-+ + + + + +-+ + +-+ + +-+ + + + + +-+ + + + + + + + + +-+-+ + + +-+ + +
| | | |   | |     |       |   | | | | |     |   | | | |   |   | |   | |     | |   |     |   | | |   |
+ +-+ + +-+ +-+-+ + +-+ +-+-+-+-+-+ + +-+ +-+-+ + + + +-+ +-+-+-+-+-+ +-+ + + +-+ +-+-+ +-+ + + + + +
|   |   | |   | | | |   |     | | |   |     | |   |                 |   | | |   |   |       | | | | |
+-+ + +-+ +-+ + +-+-+ +-+ +-+ + + +-+ +-+ +-+ +-+ + +-+ + + + +-+-+ +-+ + + + +-+ +-+ + + +-+ + + + +
|     |     |   | |     |   | |     | |   | | | | |   | | | | | |   | | | | | |       | |   | |   | |
+ +-+-+-+-+ + + + + +-+ + + +-+-+ + + + +-+ + + + +-+ + + +-+ + +-+ + +-+ + +-+ +-+-+-+ +-+ + +-+ +-+
| |     | |   | |   |   | |   |   | | |       | | |   | | | | |   |     | | |   |   |     | | |     |
+ + + + + +-+ +-+-+-+ +-+ + +-+ + + + +-+-+-+ + + + + +-+ + + + + + +-+-+ + +-+-+-+ + +-+ + + +-+ +-+
| | | | |   | |       | | | |   | |     |       |   | |   |     | |   | | |     |     |   | | |   | |
+ + + + + + + + + +-+-+ + + + + + + +-+ +-+ + + +-+ + + + + + + + +-+ + + + +-+ +-+ + +-+-+ +-+-+ + +
|   | |   | |   | | | | | | | | | | | | | | | |   | | | | | | | |   | | | | |     | | |     | |     |
+-+-+ +-+ + + +-+ + + + +-+ + +-+ +-+ + + +-+ + +-+ + +-+ + + + + + +-+ + +-+-+-+ + + +-+ + + +-+ +-+
| |   |   | |   | | |   | |     | | |   | | | |   | | |   | | | | |     |   |     | | | | | | |     |
+ +-+-+-+-+ + +-+ + + +-+ +-+-+-+ + +-+ + + +-+ +-+ +-+ +-+-+ +-+-+ +-+-+ +-+-+-+-+-+ + + +-+ +-+ +-+
|     |     |   |       |     | |     |   | | | |   | |   |   |         |   |           |   |       |
+ +-+ + + + + +-+-+ +-+ + + +-+ +-+ + +-+-+ + +-+ + + + +-+-+ + + +-+ + + + + +-+ + + +-+ +-+-+ +-+-+
| |   | | | |   |   |     | |       | | | | | |   | | |   | | | |   | | | | |   | | | |             |
+ + + +-+-+-+ + +-+ + +-+-+ +-+-+-+-+ + + + + + + +-+ +-+ + + +-+-+ +-+ + + + +-+-+-+-+-+-+-+-+-+-+ +
| | |   | |   |   | |     |         |     | |   | | |       | | |   |   | | |     |       |       | |
+-+-+ + + + +-+ +-+ +-+ +-+-+-+-+-+ + + + + +-+ + + + +-+ + + + + + +-+-+ +-+ +-+-+ + + +-+ + +-+-+ +
|     |       | |   | |   | | |       | | |   | |   | | | | |   | |   | |   | | | | | |     | |   | |
+-+-+-+-+ +-+ +-+-+-+ + +-+ + + + +-+ +-+-+-+ + +-+ + + +-+-+-+-+ + + + +-+ + + + +-+ +-+-+-+-+-+ + +
|   |   |   | |   | | | |       |   | |           | | | |   | | | | | |     | | | | | | |     |     |
+ +-+-+ + + +-+ +-+ + + +-+ + +-+-+-+ +-+-+ + + + +-+-+ +-+ + + + +-+-+-+-+-+-+ + + + + + +-+ + + + +
| | |   | |       |   |   | | |   |     |   | | | |   |   |   |         |       |   | |     | | | | |
+ + + + + + + +-+ + + +-+-+-+ +-+ +-+ + + +-+-+-+-+-+ +-+ + +-+-+ +-+ + +-+-+ +-+ + + + +-+-+-+ +-+ +
|   | |   | |   | | |   |       | |   | | |   | |   | | | |       |   | |   | |   |   | | | |   |   |
+ + + +-+-+ +-+ + +-+ +-+ + + +-+ + + +-+ + + + + +-+ + + +-+-+-+-+-+-+ + +-+ +-+-+ +-+ + + +-+-+ +-+
| |       | | | |     |   | | | |   |   | | |       | | | | | | |   | |     | |   |   |   |   |     |
+-+-+-+-+ +-+ +-+ +-+-+-+ + +-+ +-+-+-+ + +-+ +-+ +-+ + + + + + +-+ + + +-+ + +-+ + + + +-+ + + + +-+
|   |   | |   | | | | | | |   | | | | |     |   |     | | | | |   |     |       |   |   | | |   |   |
+-+ +-+ + + + + + + + + + + + + + + + + + +-+-+-+ +-+ + + + + + +-+-+-+-+ + +-+ + + + +-+ + + +-+-+ +
| | |   |   |   | |   | | | | |     |   | | | |   |     | | |   | |   | | | |     | |     | |     | |
+ + +-+ +-+ +-+ + +-+ + + + + + + +-+-+ +-+ + + + + + +-+ + + +-+ +-+ + +-+ + +-+-+-+-+-+-+-+ +-+ +-+
|     |       | | |       | | | |   | |         |   |                   | | |   |   |     |     |   |
+ +-+ + +-+-+-+ +-+-+-+ + + +-+ + + + +-+-+-+-+-+ +-+ +-+ +-+ + +-+-+-+ + + +-+ +-+ + +-+ + + + + + +
|   |   |     |   |   | | |       |   | |   |   | |     | |   | |   | |   |   |   |   | |   | | | | |
+ +-+ +-+ +-+ + + +-+ + + + + +-+ +-+-+ +-+ +-+ + + +-+ + + +-+-+ +-+ +-+-+ + +-+ +-+ + +-+-+-+ +-+ +
| | |   |   |   |   |   | | | |           | |     | |   | |         | | | | | |     | |   |       | |
+ + + + + + +-+-+ +-+ +-+ + + + +-+-+ + +-+ + + +-+-+ + + + +-+ + + + + + +-+ +-+ + + + + + + +-+-+-+
|   | | | | |     |     | | | |   | | |     | |     | | | |   | | |       | | | | | | | | | | | | | |
+ +-+ + +-+-+-+-+ + +-+-+-+-+ +-+-+ + + +-+-+-+-+-+ + + +-+ +-+ +-+-+ +-+ + + + + +-+ +-+ +-+ + + + +
|   | | |   | |   | | | | | |       | | |   |   |   | |   | |     | |   | | | |   |         |       |
+ + + +-+-+ + + + +-+ + + + + + +-+ + + +-+ + + +-+-+-+ + + +-+ +-+ + +-+ + + +-+ + +-+ +-+ +-+-+ +-+
| | | |   |     | | | | | | | | |   | |   |   |   |   | | | | |   | | | | |   | | | | | | |   |     |
+-+-+ + +-+ + + +-+ + + + + + +-+ + +-+ +-+ +-+ +-+-+ +-+ + + + +-+ + + + + + + +-+ + + + +-+-+ +-+ +
| |   | |   | | | |     |   | | | | | | | | | | |         |   | | | |   | | |   | |   |       |   | |
+ + + + +-+ +-+ + + +-+ +-+ + + +-+ + + + + + + +-+-+-+ + + + +-+ + + + + + + +-+ + +-+-+-+ + +-+-+ +
| | |   |     |   | |   | |   | |   | |   | |           | | | | |   | | | | |   |         | | |     |
+ + +-+-+ + + +-+-+-+-+ + + + + + +-+ + +-+ + +-+ +-+-+ +-+ +-+ + +-+-+ + +-+-+-+-+ + + +-+-+ +-+ +-+
| | |   | | | |           | |   |   |   | | |   | | |     |         |   |   | | |   | |   | | |     |
+ + +-+ +-+-+ + + +-+-+-+ +-+-+-+-+-+-+ + +-+ +-+ + + +-+-+-+ + + + +-+-+ + + + +-+-+ +-+-+ + + +-+ +
|       | |     | |   |       |   |   | |   |   | | | | | |   | | | | | | |   |     |     |   | |   |
+-+-+ + + +-+-+-+ + +-+ +-+ +-+-+ + +-+ +-+ +-+-+ + + + + + + +-+ +-+ + +-+ +-+-+ +-+-+ +-+ +-+ +-+ +
|     |   |           | |   | | | | | | | | |   |   | |   | |   |     |   | |     | | |   | |   | | |
+ + + + +-+ + +-+-+-+ +-+-+-+ + + + + + + + + +-+-+ +-+ +-+ +-+ +-+ +-+ + + +-+-+ + + +-+-+ +-+ + + +
| | | |   | |       |       | |   | | | | |   |           |   |   |     | |       | |   | |   |   | |
+ + +-+-+ + + +-+-+ +-+-+ + + +-+ + + + + + +-+-+-+ +-+ +-+ +-+-+ + + + + +-+-+ +-+ + + + +-+ +-+-+ +
| |   |   | |   | |     | |     |     | |     |   |   |   | | |   | | | | |   | | |   |   | |   |   |
+ + + +-+ + + + + + +-+ + + +-+-+-+-+ + + +-+-+-+ + +-+ +-+ + +-+-+-+-+ +-+-+ + + +-+-+-+ + +-+ + +-+
| | | |   | | |   | |   | |       | |   | | |   |   | |   |   |   | |       |   | |       | | | |   |
+-+-+-+ +-+-+-+-+ + +-+ +-+-+ +-+-+ +-+ + + + +-+ +-+ +-+-+ + +-+ + + + + + + +-+ +-+-+-+ + + +-+ +-+
| |   |         | | |       |   | | |         |   | |   |   |       | | | | |   |     | | |   | | | |
+ +-+ +-+-+ + + + + +-+-+-+-+ + + + +-+ +-+-+-+ + + +-+ + +-+-+-+-+ +-+ +-+ +-+-+ +-+ + + + + + + + +
| | | |     | | | |     | | | |   |     | |     | | | |           |   |   | |   | | | | | | | |     |
+ + + + +-+ +-+-+ +-+-+-+ + + + + +-+ +-+ +-+-+-+ + + +-+ + +-+-+ +-+ + +-+ +-+ + + + + + + +-+-+-+ +
|   | |   |   | | | | |       | | |   | |   | |   |   |   |     | |   | |       | |       |   | |   |
+-+ + +-+ + + + + + + +-+ +-+ + + + +-+ + +-+ + +-+ + + +-+ +-+-+-+-+ +-+-+ +-+ +-+-+ +-+-+-+ + +-+ +
|   | |   | | | | | |   |   | | | |   | |   | |   | | | | | |   | |     |     |   |         | |   | |
+-+ + +-+-+-+ + + + + + + +-+-+-+ +-+-+ +-+ + +-+ + + + + + + + + +-+-+ + +-+ + + +-+-+ +-+ + +-+ + +
|               |     | |       |               |   | |   |   |   |     |   | | |         |       | |
+-+-+-+-+-+-+-+-+-+-+-+-+-+-+-+-+-+-+-+-+-+-+-+-+-+-+-+-+-+-+-+-+-+-+-+-+-+-+-+-+-+-+-+-+-+-+-+-+-+-+