+-+-+-+-+-+-+-+-+-+-+-+-+-+-+-+-+-+-+-+-+-+-+-+-+-+-+-+-+-+-+
|   |       | | | |   |     | | | | | | |   | |   |   |   | |
+-+ + +-+-+ + + + +-+ + + + + + + + + + +-+ + + + +-+ + +-+ +
|   | | | |   |     |     |   | |   |   | |   | |           |
+-+ + + + + + + + +-+ +-+ +-+-+ + +-+ + + +-+ +-+ + +-+ +-+ +
| |   |   | | | |       |       | |   | | | | | | | |     | |
+ +-+ + +-+-+ + + +-+-+ + +-+ + + +-+-+ + + + + + + + +-+-+ +
|     | |   |             | | | |   |     |       | | |   | |
+ +-+ + + + + + +-+ +-+-+-+ +-+ +-+ +-+ +-+-+-+ + +-+ + +-+ +
|   |   | | | | | | | | |   |   |       | | | | |   | | |   |
+-+ + + +-+ +-+ + + + + + +-+-+ +-+-+ + + + + + + +-+-+ +-+ +
| | | | | | |     |   | | | | |       | |     | |   |   |   |
+ + + + + + + + +-+-+ + + + + +-+ + + +-+-+-+ + + + + + +-+ +
| | | | | | | |   | |   |   | |   | | | | | |   | | | |   | |
+ + + + + + + + +-+ +-+ + + + + + +-+-+ + + + + + +-+ +-+-+ +
| | | | | |   |     |   | |   | |                   | | |   |
+ +-+ + + +-+-+-+ +-+ + + + + + + + +-+-+-+-+ +-+-+ + + +-+ +
|   | |         | | | | | | | | | | |   |     |   |     |   |
+-+ + +-+ +-+-+-+-+ + + + + +-+ +-+ +-+ +-+ + +-+ +-+-+-+-+ +
|   | | | |           | | | | |   | | |   | | |     |       |
+-+ + + +-+-+-+ +-+ +-+-+ +-+ +-+-+ + + +-+ +-+-+ + +-+ +-+ +
| | | |     |     | |     | |   | |   |     | | | |       | |
+ + + + + +-+ +-+ +-+ +-+-+ +-+ + + + +-+ +-+ + + + +-+ +-+-+
|   | | | | | | |   | | | |       | |   | |   | | |   | | | |
+ + + + +-+ + + + + + + + +-+ +-+ +-+-+-+ + + + +-+-+-+ + + +
| | | | | |     | |       | |   | | |   | | |       |   |   |
+ + + + + + +-+ +-+ +-+ +-+ +-+ +-+ +-+ + + + + + + +-+ + + +
| |     | |   |   |   | |   |   | | | |     | | | | | |   | |
+ +-+ + + +-+ + +-+-+-+ +-+ + +-+ + + + +-+ + + + + + + +-+-+
|   | |     | | | |   |   | |   | | | | | | | | | | |     | |
+-+ +-+ + +-+-+-+ +-+ +-+ + + +-+ + + + + + + +-+ +-+ +-+ + +
|   | | |   | |     |           |       |   | |   |   | |   |
+-+ + +-+ +-+ +-+ + +-+-+-+-+ + +-+-+ +-+ +-+ +-+ + + + +-+ +
|       | | | |   |   | |   | |   |   |     | | | | | |     |
+-+-+-+ + + + +-+-+ +-+ + + + + +-+-+ +-+-+-+-+ + + +-+ + + +
|   | | |   | |     |     | | | |         | | |   |   | | | |
+ +-+ +-+-+ + + + +-+ +-+-+ +-+ +-+ +-+ + + + + + +-+-+-+ +-+
|     | |   |   |   | | |     |   | | | | |     |       |   |
+ +-+-+ + +-+-+ +-+ + + +-+-+ + +-+-+ + +-+ +-+-+ + + +-+ +-+
| | |   | |   | |             |       | |   |   | | | |     |
+ + +-+ + +-+ + +-+-+-+ +-+ + +-+-+ + + + + +-+ +-+-+ +-+ +-+
| |   |             | | |   | |   | | | | | | | | | | |     |
+ + + +-+ +-+-+ + +-+ + + + +-+-+ +-+ +-+ +-+ + + + +-+-+-+ +
|   |   | | | | | |   | | |       |     | | | |   | |       |
+ + +-+ + + + + + +-+ +-+-+ +-+ +-+ +-+ +-+ + + +-+ + + +-+ +
| | | | | |     | |   | |     |   |   | | | |         | | | |
+ +-+ + + + +-+ +-+-+ + + +-+-+ + +-+-+ + + +-+ + + +-+-+ + +
| |   |   |   | | | |     | | | |   |   | |   | | |       | |
+ + + +-+-+-+-+ + + + +-+ + + + +-+ + +-+ + +-+-+ +-+-+-+-+-+
| | |   |   | |   | | |   |     |   |     |     |   | |     |
+ + +-+-+ + + + +-+ +-+-+-+-+-+ +-+-+ +-+ +-+-+ + +-+ +-+-+ +
| |   | | |         |   | | | | | | | |     |   | |   |     |
+ + + + +-+ +-+ + +-+ +-+ + + + + + +-+ +-+ +-+ + + +-+ +-+-+
| | |     | |   |     | | |   | | | | |   |     | | |   |   |
+ + +-+-+ + + +-+ +-+-+ + +-+ + + + + +-+-+-+ + + + + +-+ + +
|     |     | |       |   | | | |   |     | | | | |   |   | |
+-+ + +-+-+ +-+ +-+-+-+ +-+ + + + +-+ +-+-+ + + +-+ + +-+-+ +
|   | |   | | | |   |     |       | |     | | |       | |   |
+ +-+ + +-+ + + + +-+ +-+ + + + + + +-+-+ + + + +-+-+ + +-+ +
|   |         | |       |   | | |       |     |     |       |
+-+-+-+-+-+-+-+-+-+-+-+-+-+-+-+-+-+-+-+-+-+-+-+-+-+-+-+-+-+-+