+-+-+-+-+-+-+-+-+-+-+
| |       | | | |   |
+ + + + + + + + + +-+
|   | | |     | | | |
+ +-+-+ + + + + + + +
| | | | | | | |   | |
+ + + +-+ +-+ +-+ + +
|       |   | |     |
+ +-+ + + +-+-+ + +-+
| | | | |   | | | | |
+ + +-+-+-+ + + + + +
|       | |   | |   |
+ + + +-+ + +-+-+-+ +
| | |   |     |   | |
+ + + + + + + + + + +
| | | | | | |   |   |
+ + + + +-+ +-+-+-+ +
| | | |   |   |   | |
+-+ +-+-+-+ +-+-+ + +
|         |       | |
+-+-+-+-+-+-+-+-+-+-+