+-+-+-+-+-+-+-+-+-+-+-+-+-+-+-+-+-+-+-+-+-+-+-+-+-+-+-+-+-+-+-+-+-+-+-+-+-+-+-+-+
| |   |   | |   | |   | |   | |   | |   | |       |   | |   |     | |   |   | | |
+ + + +-+ + + +-+ +-+ + +-+ + +-+ + +-+ + + + +-+ +-+ + +-+ +-+-+ + + + + +-+ + +
|     |   | | |   |   | |     |     | |       | | |                     |   |   |
+ +-+-+-+ + + +-+ + + + + +-+ +-+-+ + + + +-+-+ + +-+-+ +-+-+-+ + + + + + + +-+ +
|         |   |   | | | |   |       |   | |     |   | | |   | | | | | | | | |   |
+-+-+ + +-+ +-+-+ + + + +-+ +-+-+-+-+-+-+ + + + + +-+ + + + + +-+ + +-+-+-+ + +-+
| |   |             |   | |           |     | |             | |   | | |   | | | |
+ + + +-+-+-+ + +-+ +-+ + +-+-+-+ +-+ + + +-+-+ + +-+ +-+-+ + + +-+-+ + + + + + +
| | |   | | | |   | | | |     |   | | | |   |   |   | |       |         | | |   |
+ +-+ + + + +-+-+ +-+ + + + +-+ +-+ + +-+-+ +-+ + +-+ + + + +-+-+-+-+-+ + + +-+ +
| |   | | |   |   |     | |   |   | |         | | |   | | | | |         | | |   |
+ +-+-+ + + +-+ + + + + + +-+ + +-+ + +-+ +-+-+ + + +-+-+-+-+ + + +-+ + +-+ + +-+
|       | |     | | | |   | |     | |   |   |   | |   |   | | | | | | |     | | |
+ + + + + + +-+ + +-+ + + + +-+-+ + +-+-+ +-+-+-+ + + +-+ + + +-+ + + + + + + + +
| | | | |   |   |   | | | | | | | | | |         | | |   |         | | | | | |   |
+-+-+ + + + + +-+-+ + + +-+ + + + + + +-+ + + +-+-+ + +-+ + +-+ +-+ +-+-+-+ + + +
|   | | | | | |   | | | |   |         | | | | | |   |     |   | | | | |   |     |
+-+ +-+-+-+-+ +-+ + +-+ +-+ + +-+-+-+-+ +-+ +-+ + +-+ +-+-+ +-+ + + + +-+ + + +-+
|             |   | | | | | | | |         | | | |   |   | | | | |     | |   |   |
+-+-+ +-+ +-+ +-+ + + + + + + + + + +-+-+ + + + +-+-+-+ + + + + + + +-+ +-+ +-+-+
| |     | |       |   | | | | |   |     | | |   | |       |   |         | |     |
+ + +-+ +-+-+-+ +-+ + +-+ + + + +-+ +-+ + + + + + +-+ + +-+ +-+-+ + + + + + +-+ +
| | |   | | | |   | |     |   |   |   | | |         | | | | |   | | | | |   | | |
+ +-+-+ + + + +-+ + + +-+ + + +-+ + +-+ + +-+ + + +-+ + + + +-+ +-+-+-+-+ +-+ + +
| | |           | | | |   | | | | | | | |     | | | | |   |       |   | |     | |
+ + + +-+ + + + + +-+-+-+ + + + +-+ + + + + +-+-+-+ + + + + + + +-+-+ + +-+-+ +-+
|       | | | | |     | | | |     | |   | |     |   | | | | | |     | |     |   |
+-+ + +-+ +-+-+ + + +-+ + + + + +-+-+ + + +-+ + +-+ + + + + +-+ +-+-+ +-+ + +-+ +
|   |   |     | | | |   | | | | | |   | |   | | | | | | | |   | |         | |   |
+ +-+ + +-+-+-+ + +-+-+ + +-+ +-+ +-+-+ +-+-+ +-+ + + + + +-+-+ +-+ + +-+ + +-+ +
| | | |   | | | | | | |     | |   | | |     |   |     | |   | | | | |   | | | | |
+ + +-+ + + + + + + + +-+ +-+ +-+ + + +-+-+-+ + +-+-+-+ + +-+ + + +-+-+ + +-+ + +
| |     |     | |   |     | |     | |     |   |       | | | |   |       | |   | |
+-+ + +-+-+ + +-+-+ + + +-+ + + +-+ +-+ +-+ +-+ +-+ +-+-+ + +-+ + +-+-+-+-+-+ + +
| | | |     | |     | | | | | | |   |   | |   |   | | | | |   |         | |   | |
+ + +-+ + + +-+-+-+-+ + + + +-+ +-+ + + + +-+ + + + + + + +-+ +-+-+-+ +-+ + + + +
| | |   | |   |       |     | | | |   |   | | | | |     |       | |       | |   |
+ + + +-+-+-+-+ +-+-+ +-+ +-+ + + + +-+-+ + +-+ + +-+-+-+ +-+ +-+ +-+-+ + +-+ + +
|   |             |     |     |             |   |   |     |           | |   | | |
+-+-+-+-+-+-+-+-+-+-+-+-+-+-+-+-+-+-+-+-+-+-+-+-+-+-+-+-+-+-+-+-+-+-+-+-+-+-+-+-+