+-+-+-+-+-+-+-+-+-+-+-+-+-+-+-+-+-+-+-+-+-+-+-+-+-+-+-+-+-+-+-+-+-+-+-+-+-+-+-+-+
|         |   | | |   |             | |   |     | | |   |   | | | |   |   | | | |
+ + + + +-+ +-+ + + +-+ +-+-+ +-+-+-+ + + + +-+-+ + + +-+ + + + + +-+ +-+ + + + +
| | | |     |   |   |   |   |       |             |       | | |       |   | |   |
+-+-+-+-+-+ +-+ + + +-+ +-+ +-+ +-+-+-+-+ +-+ + + +-+-+ + +-+ + + + + + +-+ + + +
| | |   | | | |   |   |   | |     |         | | |                 | |   | |     |
+ + + +-+ + + +-+ + + + +-+ +-+ +-+ +-+ +-+-+ +-+ + + + +-+-+ + + +-+ +-+ +-+ +-+
| | |       |   | | |     | |   |   | |   | |   | | | |     | | |   | |     |   |
+ + + +-+ + +-+ +-+-+-+ +-+ + +-+ + + +-+ + + + +-+-+ +-+ + +-+ +-+ + + + + +-+ +
| |   | | | |       | |     | |   | | | | | | |   |     | | | |   | |   | |   | |
+ +-+ + + + +-+-+-+ + +-+ + +-+-+-+ + + + + +-+-+ + +-+ +-+-+ + +-+ +-+ + +-+-+ +
| |     | | |   |   |     | | |     | |   | | |   |   | |   |   |   | | |       |
+ + +-+-+ + + + + + + + + + + +-+ + + +-+ + + +-+ + + + +-+ + + + +-+ + +-+ + +-+
| |   | | | | |   |   | | |         | |     |   | | | |     | | |   |   | | |   |
+ + + + + + + +-+ +-+-+ +-+ + +-+-+-+ + + + +-+ + + +-+ +-+ + + +-+ +-+ + +-+-+ +
|   |   | |   | |   | | |   |       | | | | | | | | | | | | | |   | |         | |
+ + + + +-+-+-+ + +-+ +-+-+ +-+-+-+-+ + +-+ + + + + + + + + +-+ + + +-+-+ + +-+ +
| | | | |   |     | |   |   | |   |   | | | | |   |   |   | |   | | |     | | | |
+-+ + +-+ +-+ + +-+ + +-+ + + + +-+-+ + + + + +-+-+ + + +-+ +-+-+-+-+ +-+ + + + +
| | | | | | | | | |   |   |   | |   | | | | |       | | | | | | |       | |   | |
+ +-+ + + + + + + + +-+ + + +-+ + +-+ + + + + +-+ +-+-+ + + + + + + +-+-+-+-+-+-+
| |   |   | | |   | |   | | | | | |   |   | | | | | |   | | | | | |   | |   | | |
+ +-+ + + + +-+-+ + +-+-+-+ + + + + +-+ + +-+-+ + + +-+ + + + + +-+-+ + +-+ + + +
| | | | |     |   | | | | |           | | |     |   |   | | |       | | |   |   |
+ + + + + +-+-+-+ + + + + +-+-+-+-+ + + + +-+-+ +-+ + +-+ + + +-+-+ + + +-+ +-+ +
|     | |   |   | |   |             | | |         | | |       |   | | | |     | |
+-+-+ +-+ +-+ +-+ + +-+ + +-+-+ +-+-+-+-+-+-+-+ + + +-+ + + + + + +-+ + +-+ +-+ +
|   | |   |   | | | |   |     |           |     | | |   | | |       | |   |     |
+ +-+ +-+ + + + + + +-+-+-+ +-+ + + +-+-+ +-+ +-+-+-+ + +-+ + +-+ +-+-+-+ + +-+-+
|             | |     | | | |   | |   | |   | |     | |   | | | | | |   |   |   |
+ +-+ + + +-+ + + +-+ + + +-+-+-+-+-+ + +-+ +-+ + + +-+-+-+-+ + + + +-+ +-+ + +-+
| |   | | | |   |   |   |   | |   |       |   | | |   |     | |     |     |     |
+ + + + +-+ + + + +-+ + + +-+ + +-+-+-+-+-+ +-+ +-+-+ + +-+-+-+ + +-+ + +-+ +-+-+
| | | | | | | | |   | |   |       | |     | | | |   | | |   | | | | | |       | |
+ + +-+-+ + + + +-+-+-+-+-+-+ +-+-+ +-+-+ + + + + +-+ + +-+ + + + + +-+ +-+-+-+ +
| | | | |     |   |     | |   | |   |     |       |   | |       |   | | | |     |
+ + + + +-+ +-+ + + +-+-+ +-+ + +-+ + +-+ +-+ +-+-+ +-+ + +-+ +-+ + + + + + + + +
| | |   |   |   |   |       | |     | |   |     |   | |     | |   |         | | |
+ + +-+ +-+ +-+-+ + +-+-+ + + +-+-+ + +-+ + + +-+ +-+ + + + +-+ +-+ +-+-+ +-+-+ +
| |     | | |   | | |     | |   |         | |   |     | | |   |   |     | | | | |
+ +-+-+-+ + + + + +-+-+ + +-+ +-+-+ + +-+ +-+ + + + + +-+ +-+ + +-+-+-+ + + + + +
| | |   |   | | |         |     |   |   | | | | | | |   | | | | |       |   |   |
+ + + +-+ + +-+ +-+-+ + + + + +-+ + + + +-+ + + +-+-+-+-+-+ +-+-+ +-+-+-+ +-+-+-+
|       | | |   |   | | | | | | | | | |       | |     | |         | |         | |
+ +-+ +-+ + + +-+-+ + + + +-+ + +-+ + +-+ + + + +-+ + + +-+-+ + + + + + +-+-+ + +
| | | | | |       | | | |   |     | | | | | | |   | |   |     | |   | |   | | | |
+ + + + +-+ + + + + + +-+ + +-+ + +-+ + + + +-+ +-+ + +-+ + + +-+ + +-+-+-+ + + +
| | | |     | | | | | | | |         | | | | | | |   | |   | |   | |   | |   |   |
+ + +-+ +-+ + +-+-+ + + +-+-+-+-+-+-+ + +-+ + + +-+ +-+-+-+ +-+ +-+ +-+ +-+ +-+ +
|     | | | |     |   |             | | |   | |     |         | | |   |   | |   |
+-+ +-+ + + +-+ + +-+ +-+-+-+-+-+-+ + + + + + + + + +-+-+ +-+-+ + + + + + + + +-+
| |   | |   | | | |     | |     |   |   | | |   | | |   | |     | | |   | |   | |
+ + +-+-+ + + +-+ +-+ + + + +-+ + +-+-+-+-+ + +-+ +-+ +-+ + + +-+ + + + + +-+ + +
| |     | |     | | | |             | |   | | |         | | |     | | | | | |   |
+ +-+-+ +-+-+ + + + +-+-+-+-+-+-+-+ + + + +-+ + +-+-+ + + + +-+ + +-+ + + + + + +
| |         | | | |   | | | | |   | |   | |   | |     | | |   | | | | | | | | | |
+ + +-+-+-+-+ +-+ +-+ + + + + +-+ + +-+-+ + +-+ + +-+ +-+ + +-+-+ + +-+ + + +-+ +
|   |           |   |   | |           |   |   | |   |   | |     | |   | | | |   |
+-+ +-+-+ +-+ +-+-+-+-+ + + +-+ +-+ + +-+ +-+-+ + +-+ + +-+-+ + +-+-+ + +-+ + +-+
| | |   |   |   |       |     | | | | |   |     | | | |   | | |       |   | | | |
+ + + +-+ +-+ +-+ +-+ +-+ + +-+ + + + +-+ +-+ + +-+ + +-+-+ + +-+-+-+ +-+-+ + + +
| | | | | |   | | |   | | | | | |   |   |   | |   |     |   |     | |   |   | | |
+ + + + + +-+-+ + + + + + +-+ + + +-+-+-+-+ +-+ +-+ +-+ +-+ +-+-+ + + + + + + + +
| |     | |   |   | | |     | | | | | |   |       |   |   | | |   | | |   | |   |
+ +-+ + +-+-+ + + +-+ + +-+ + +-+ + + + + +-+-+ +-+-+-+ + + + +-+ + + + + +-+-+-+
|   | | | | |   | |       | |       |   | |           | | |       |   | |       |
+-+ + + + + +-+ +-+ +-+ +-+ +-+ +-+ +-+ + +-+ + + + + +-+ +-+-+ + + +-+ +-+ + +-+
| |   |   | | |   | |     |   | |     | |     | | | | |     |   | | | |   | |   |
+ + + +-+-+ + +-+-+ + +-+ +-+ + + + + + +-+-+-+ +-+ + +-+ +-+ +-+ + + + + +-+-+-+
|   |     | |     | | | | |   | | | | | | | | | |   | | | |   | | |   | |     | |
+-+-+-+-+ + + +-+ + + + + +-+-+-+ +-+-+ + + + + + +-+-+ + +-+ + + + +-+-+ +-+ + +
| |       |     |   | | | |         |   | |   | |     | |   |   | |     | | | | |
+ + + +-+-+ +-+ + + +-+ + + +-+-+ +-+-+-+ +-+ + + + + + +-+-+ +-+ +-+-+-+ + + + +
|   | | | |   | | | |     | | | | |   | | | |   | | | |   | |   |   | | |   | | |
+-+-+ + + + + +-+-+ + + + +-+ + + +-+ + + + +-+-+ + + +-+ + +-+ +-+ + + +-+ + + +
| | | | |   |   |   | | | | |   | | | |   | | | | | |         |   |   |     | | |
+ + + + + +-+-+ + +-+ + + + + + + + + + + + + + + + +-+ +-+-+ + + + + + + +-+-+ +
|   | |       | | |   | |   | | | | | | |   |     |   |     | | | | | | | |   | |
+ +-+ + +-+ + + + +-+-+-+ +-+ + + + + + +-+-+-+-+-+ + + + + + + + + +-+-+-+-+ + +
|     |   | | | |     |   |   |                 |   | | | | | | | |             |
+-+-+-+-+-+-+-+-+-+-+-+-+-+-+-+-+-+-+-+-+-+-+-+-+-+-+-+-+-+-+-+-+-+-+-+-+-+-+-+-+