+-+-+-+-+-+-+-+-+-+-+-+-+-+-+-+-+-+-+-+-+-+-+-+-+-+-+-+-+-+-+-+-+-+-+-+-+-+-+-+-+
|     | |   |   | |   |       |     | | | | |     | | |   |   | | | | | |       |
+-+ +-+ +-+ +-+ + +-+ + +-+-+ + +-+-+ + + + +-+ +-+ + + + +-+ + + + + + + +-+ + +
|       |   | | |   |   |   |     |       | | | | |     |   |   | |   |     | | |
+-+ +-+ +-+ + + +-+ + +-+ + +-+ + +-+ +-+-+ + + + +-+ + +-+ +-+ + + + +-+ + + + +
| |   |     |   | |       | |   |   |     |     |     | | |   | |   | |   | | | |
+ + +-+-+ +-+-+ + +-+-+-+ +-+ + +-+ + +-+-+-+-+ + +-+-+ + +-+ + +-+-+ +-+-+ +-+ +
| | | | | |       | |       | |   |   |   | | |   |     |         | |   |     | |
+ + + + + +-+ +-+ + +-+ + +-+ +-+-+-+ + + + + + + +-+-+-+-+-+-+-+ + +-+ + +-+ +-+
| |   | |       |   |   |   |   | | | | | |     | | | |   |     |   |   |   | | |
+ +-+ + +-+-+-+ + + + +-+ +-+-+ + + + + + + + +-+-+ + + +-+-+-+ +-+ + +-+ +-+ + +
|   |     |   | | | |   |   |     | |     | | |     |     |         |   |   |   |
+ + +-+ + +-+ +-+ + + + +-+ +-+-+-+ + + + + +-+ + +-+ + + + +-+-+-+ + +-+ +-+-+ +
| |   | | | |   | |   |   | | |     | | | | |   |   | | | | | |   | |         | |
+-+ +-+ +-+ +-+ +-+ +-+ + + + + + + +-+ +-+ +-+-+-+ +-+-+ + + + +-+ +-+-+ +-+-+-+
|   | | |           | | | |   | | |   | |       | |   |   | |     | |     | | | |
+ + + + +-+ + + +-+ + +-+-+ + + +-+-+-+ +-+-+ +-+ +-+ + +-+ +-+-+ + +-+ + + + + +
| | | | |   | | | | | |   | | |     |   |     | | |   | |         |   | | | | | |
+ + + + + + + +-+ + + +-+ + +-+-+-+ +-+ + + +-+ + +-+ + +-+-+ + +-+ + + + + + + +
| |     | | | |       |   | | |   | | |   | |       |     |   | |   | | | | | | |
+-+ +-+-+ +-+ + +-+ +-+-+ + + +-+ + + + +-+ + +-+-+ +-+-+ + + +-+-+-+ +-+ + + + +
| |   | | |   | | | | | |   |           |         |   | | | | |   |     |     | |
+ + + + + + +-+-+ + + + +-+-+-+ + + +-+-+ +-+ +-+ + + + + +-+ + + + + +-+ + + + +
| | | | | |     | |     |   | | | | |     |     | | | | | | | | |   | |   | | | |
+ + + + +-+-+ + + + + + +-+ + + + +-+-+-+-+ +-+-+ + + + + + +-+-+ +-+-+-+-+-+ + +
|   |   | | | | | | | | | | |   | | |   |   | |   | |     | | |       |   | |   |
+ + +-+ + + + + + + +-+ + + +-+-+ + +-+ +-+ + + +-+ +-+-+ + + + + + +-+ +-+ +-+ +
| |   | | |   |   | |   | | |             | | |   | |         | | |     | |     |
+-+ + + + + +-+-+ + + +-+ + + +-+-+-+ +-+ +-+ +-+-+-+ +-+-+ + + + +-+ +-+ +-+-+ +
|   | |   |   | | | | |     |     |     | |   | | | | | |   | | |   | | | |   | |
+-+ +-+-+-+-+ + +-+ +-+-+ +-+-+ + +-+-+-+ +-+ + + + + + + + +-+ +-+ +-+ + + + + +
| |     | |     | |     | | | | | |       | |           | |   |   |   |     |   |
+ + + +-+ + +-+-+ + +-+ + + + +-+ + +-+ + + +-+ +-+-+-+-+ + + + + +-+-+ + +-+-+-+
|   | | | |   | |     |   |     | |   | |     | |   |   | | | | | |   | | | | | |
+-+ + + + + + + +-+ + + + +-+-+ + + + + +-+ + +-+ +-+ +-+-+-+ + +-+-+ + +-+ + + +
| | | | |   |     | | | | |   | | | | | | | | | |   | |   |   |   |     |   |   |
+ + +-+ + + +-+-+ +-+ + + +-+ + +-+-+-+ + + +-+ +-+ + +-+ +-+ +-+-+ + + +-+ +-+ +
| | |     |     | | | | | |     | |     |         | |   |     |     | | |     | |
+ +-+-+-+ +-+ + +-+ +-+-+ +-+-+ + +-+-+ +-+-+ +-+ + +-+ +-+ + +-+ + + + +-+ + + +
|     | |   | | | | | |   |   | | | |       | | | |       | |   | | | |     |   |
+-+-+ + +-+-+ +-+ + + + +-+-+ + + + +-+-+ + + + + + + +-+-+-+-+ +-+ + +-+ + +-+-+
| | |     | |   |     |     |     |   |   | |   | | | | | |   | | | |   | |   | |
+ + + +-+-+ +-+ +-+-+ + + + + +-+ + + + +-+-+ + + + + + + + +-+ + +-+-+-+ +-+-+ +
| |       | |         | | |     | | | |     | | | | | |     |     |     |       |
+ + +-+-+ + +-+-+ + + +-+ +-+ +-+-+-+ +-+-+ +-+-+ + + +-+ + +-+ +-+ +-+ +-+ + +-+
| | |   |   |   | | | |     |   |   | | |   |     | |   | |   | |   | | | | |   |
+ + + +-+-+ + +-+-+-+-+ +-+-+ +-+ +-+ + + +-+ +-+-+-+-+ +-+-+ + +-+ + + + +-+ +-+
|         | | | |     | |     | | |       | |   | |                 |     | |   |
+ + +-+-+-+ + + + +-+-+-+ +-+-+ + +-+ + + + + + + + + + + +-+-+ + + + +-+-+ +-+ +
| |   | |     | |     | | |   |     | | |   | | | | | | |     | | | |           |
+ +-+-+ +-+-+ + +-+ +-+ + + + +-+ +-+-+ + + +-+ + +-+-+ +-+-+-+ +-+ + + + +-+-+-+
|     |   | |     |     |   |   |       | |   | | | | |   |       | | | |       |
+ + +-+-+ + +-+ +-+-+-+ + + +-+ +-+ + + + +-+ +-+ + + +-+ +-+ +-+ + +-+ +-+ +-+-+
| |   |   | | |   |   |   | |     | | | | | |   | |   | |   | |   |   |   |     |
+-+-+ + + + + + +-+-+ + +-+-+ + +-+ + +-+ + +-+ + + +-+ + +-+ + +-+ + +-+-+-+-+-+
|       |     |   | | |     | |   | | |       | | |   |     | | |   |     | |   |
+ + + +-+ +-+-+-+ + + + + + + +-+ + + + +-+-+-+-+ + +-+-+ +-+-+-+ + + + + + + + +
| | |   | |   | | | | | | | | |   | | |           |       | |   | | | | |     | |
+ +-+ + +-+-+ + + + + +-+ + +-+ + + +-+-+-+-+-+-+-+-+ + + + +-+ +-+ +-+ + +-+ + +
| | | |   |     |   | |   |   | | | |     | | |     | | |         |   | | |   | |
+ + +-+-+ + +-+-+ +-+ + +-+ + + +-+-+ + +-+ + + +-+-+-+ + + + +-+ + +-+-+-+ + +-+
| |   | |       | | | |   | | |       |       |   |     | | | |   |   |   | |   |
+ +-+ + +-+ +-+ + + + + +-+ +-+-+-+-+ +-+ +-+ +-+ +-+ +-+-+-+ +-+-+ +-+-+ + + + +
|   | |     |   | | |     | |   |       |   |       |       |     | |   | | | | |
+-+ + + + + +-+ + + + + +-+ +-+ + +-+ + +-+ +-+-+-+ +-+ + +-+-+-+ + + + + + + +-+
|     | | | |   | | | | | | | |     | | |   |       | | |       | | | | |   |   |
+ +-+-+-+-+ + + + + + +-+ + + + + + + +-+ + + + + +-+ +-+ + +-+ + +-+ + + +-+-+ +
| | | | | | | | |     |   |   | | | |   | | | | | | | |   | | | | | | |   |     |
+ + + + + + + +-+ + +-+-+ +-+ +-+-+-+ + +-+ +-+-+-+ + + + + + + +-+ + +-+-+ +-+ +
|         | | | | | | | |     | | | | | |   | |     | | | | |     |     | | |   |
+-+ +-+ +-+ +-+ + +-+ + +-+ + + + + + + +-+-+ +-+ + + + + + + + + + + + + +-+-+ +
|     | | | |   |   | |   | |   | | | |   | | |   |   | | | | | | | | | |   | | |
+ +-+ +-+ + + + + + + +-+ + + + + + +-+ +-+ + + + + +-+-+ + +-+-+-+ + + + +-+ + +
|   | | | |   | | |   | | | | |   |       |     | |       | |     | | |   |   | |
+-+ +-+ + +-+ + +-+ + + + + +-+-+-+-+-+-+-+-+ +-+ +-+-+-+-+ + +-+-+-+-+ +-+ + + +
| | | | | | | |   | | | | |     |   |         |     |     | | |     |     | |   |
+ + + + + + +-+ + + +-+ + + + +-+ +-+ +-+-+ +-+-+-+-+-+ + + + + +-+-+ +-+ +-+-+ +
| |   | | |     | |     |   | | | | |     | | | |     | |   |   |     | |   | | |
+ + +-+ + + + + +-+ + + +-+-+ + + + + +-+-+-+ + + +-+-+-+ + +-+ +-+-+ + +-+ + + +
|         | | | |   | | |     |                         | |       |     |   |   |
+-+-+-+-+-+-+-+-+-+-+-+-+-+-+-+-+-+-+-+-+-+-+-+-+-+-+-+-+-+-+-+-+-+-+-+-+-+-+-+-+