+-+-+-+-+-+-+-+-+-+-+-+-+-+-+-+-+-+-+-+-+-+-+-+-+-+-+-+-+-+-+-+-+-+-+-+-+-+-+-+-+-+-+-+-+-+-+-+-+-+-+
| |     |       |   |   | |     |   | |   | |   |   | |     | |     |       |     | | | |   | | | | |
+ +-+-+ +-+-+ +-+-+ + +-+ + +-+ +-+ + +-+ + +-+ +-+ + + +-+-+ +-+ + + + +-+ + +-+ + + + + +-+ + + + +
|     | |     | | | | |   |   |   | | |       | |     | | |   | | | | | |   | |   |     | | |       |
+-+-+ + +-+-+ + + + + +-+ +-+ + +-+ + +-+-+ + + + +-+-+ + + +-+ + +-+ + + +-+-+-+ +-+-+ + + +-+-+ + +
|   |   | | | |     | |         |   |   |   |   | |     |   | |           | |   | | | | | | | |   | |
+-+ + +-+ + + +-+-+ + +-+ + + + +-+ + + +-+ + + + + + + + +-+ + + + + +-+-+ +-+ + + + + + + + +-+ + +
| |     | |   | | | |     | | | |   | |   | | |     | | | |   | | | |             |   | | | |   | | |
+ +-+-+ + +-+ + + + + +-+-+ +-+-+ + + +-+ +-+-+-+-+ +-+-+ +-+ + + +-+ +-+-+-+ +-+ +-+ + + + + + +-+ +
|   |   | | | | |   | | | | |     | | | |   | | | | |   |       |   | | | | | |   |     |       | | |
+ + + +-+ + + + + + + + + + + + + + + + + +-+ + + + + + +-+-+-+ + +-+-+ + + +-+-+ +-+ + + + + +-+ + +
| | |     |     | |   |           | |   |   | |     | | |     | |   |   |   | |     | | | | |   | | |
+ + + + + + + + + +-+-+-+ + +-+-+-+ +-+-+ + + +-+ +-+ +-+-+-+ + + + + + + + + +-+ +-+ +-+-+ +-+-+ + +
| |   | |   | |   |     | | | | | |     | | | |   |   |     | | | | | |   |   | | | |   | |   | | | |
+ +-+ + + +-+-+ + +-+ + + + + + + +-+-+ +-+ + +-+ +-+ +-+ + + +-+ + + + + + + + + + + +-+ +-+ + + + +
|   | | | | |   | | | |   |   | | | |     | |       | | | |   |   | | | | | | | | | | |   | |       |
+ + +-+ + + + + +-+ + +-+-+ +-+ + + +-+-+ + +-+ + + + + + +-+-+ +-+ + +-+ +-+-+ + + + + +-+ +-+ + + +
| |   | | | | | |   |     |   |       | |   |   | | |   |       |           |       |   |       | | |
+ + + +-+-+ + + + + +-+ + +-+-+ + +-+-+ +-+ + +-+ + +-+ + +-+-+-+ +-+-+-+ +-+ + +-+ + +-+ + + +-+ + +
| | |   | |   |   | |   | |     |   |   | | | |   |   | |     |       | | |   | | | |   | | | | | | |
+-+-+-+ + + + + + + + + + +-+-+-+ + +-+ + + + + + + + + + + + +-+ +-+-+ + + + + + + + + + +-+ + +-+ +
|   | |   | | | | | | | | | |     |   |   | | | | | | |   | | | |       | | | | | | | | | |     | | |
+-+ + + +-+ +-+-+ +-+ +-+ + + +-+ +-+ +-+ + + +-+ + +-+ + + +-+ + + + + + +-+-+ + + +-+ + + + + + + +
|     |   | | | |   |   | | | |     | |       | | |   | | | |   | | | | | | | | |   | | | | | | | | |
+ +-+-+ + +-+ + +-+-+ +-+-+ +-+-+-+ + +-+ +-+ + + +-+-+ +-+-+ +-+-+-+-+ + + + + + + + + +-+-+ +-+ + +
|   |   |   | |       | | |     |   | | |   |   |       |       | |   | | |   | | | | |   |   |     |
+ + +-+ +-+-+ +-+ +-+-+ + + +-+-+ + + + + + + + + + + +-+ + + +-+ + +-+ +-+ + +-+-+ + + +-+-+-+ + +-+
| |   | |   |   | |     |   | |   | | |   | | | | | | | | | |   |   |     | |       | |     | | |   |
+ +-+ + +-+ +-+ + +-+ + +-+ + + +-+-+-+ + + + +-+-+ + + +-+-+ + + + +-+ +-+-+ + + + + + + +-+ +-+-+ +
| | |   |     |   |   |       |       | | | |     | | |     | |   |   |     | | | | |   |   | | | | |
+ + + + + + +-+ +-+ +-+-+ + + +-+ + +-+ + +-+-+-+-+ +-+-+ +-+-+ +-+ + +-+-+-+ + + + + +-+-+ + + + + +
| |   |   | | |             |     | | | | |           |       |   | |   | |   | | | | |           | |
+-+-+ +-+-+-+ +-+ + + + + +-+-+-+-+-+ +-+-+-+-+-+-+ +-+ + + +-+ + + + + + +-+-+ +-+-+-+-+-+-+ +-+-+ +
|     | |   | |   | | | | |   | | |     | |     | | | | | |   | | | | | | | |                   | | |
+-+-+ + + + + +-+ + + + +-+ +-+ + + +-+-+ +-+-+ + + + + +-+ +-+ +-+ + +-+ + + +-+ +-+-+-+ + + + + + +
| | | |   |   |   | | |   | |   |     |             | |   | |   | | |   | | | |   | | |   | | |     |
+ + + + + + +-+ +-+-+-+-+ + +-+ +-+ +-+ +-+-+-+ +-+-+ +-+-+ +-+ + +-+ +-+ + +-+-+ + + +-+-+ +-+ +-+-+
| | | | | | | | |   |   | | | | |   | |   | |   | | | |     | | | |   |   | | | |   |   | |   | |   |
+ + + +-+ + + + +-+ +-+ + + + + +-+ + + + + +-+ + + + +-+ +-+ + + + +-+ + + + + +-+ + +-+ + + +-+ + +
|     | | |   | | |   | |           | | | | |       | |       |   |     | |         | |     | |   | |
+ + + + + +-+-+ + + +-+ +-+-+ +-+ + + +-+ + + +-+-+-+ + +-+-+ + +-+-+ + + +-+ + + + + +-+-+ +-+-+ +-+
| | | |   | |   |   |     |   |   | | | |   |     |     | | | | | | | | |   | | | |       | | | |   |
+ + +-+ + + + + + +-+ +-+ +-+-+-+-+ + + +-+-+ +-+ + + +-+ + + + + + + +-+-+ +-+-+-+-+ +-+-+ + + +-+ +
| | | | |   | | | | |   |   | | | |   |   | |   | | | |     |   | |   | |       |         | | |   | |
+-+ + +-+-+ +-+ + + + + + + + + + + +-+ +-+ +-+ +-+ +-+-+ +-+ +-+ + + + +-+ + + + +-+ +-+-+ + + + + +
| |     | | | | | |   | | | |     | | | |   | |   | | |         | | |     | | | | |     | | | | |   |
+ +-+-+ + + + + + +-+-+-+ + +-+ + + + + + +-+ + + + + +-+ + +-+-+ +-+-+-+ +-+-+-+-+ + + + + + + +-+-+
| |   |       | |   |     |   | | |         | | |   |   | | | | |     |             | |   |     |   |
+ + + +-+-+ + + +-+ +-+ +-+ +-+ +-+ +-+-+ + + + +-+ +-+ +-+ + + +-+-+ + + +-+ + +-+-+ + +-+-+ +-+ +-+
| | |       | |         |       | | |   | |   |   | |   | |   | | |   | | | | | |   | |     | | | | |
+ + + +-+-+ +-+-+-+-+-+-+-+-+-+ + + +-+ + +-+ +-+-+ + +-+ +-+ + + +-+ + + + +-+ +-+ +-+-+ +-+ + + + +
|   | |   |         |     | |   |   | |   |   | |   |   | | | |   |     |     | |   | |     |       |
+ +-+-+-+ + +-+ + + +-+ +-+ +-+ + +-+ +-+ + +-+ + +-+-+ + + + +-+ +-+-+-+-+-+-+ +-+ + + + + + + + + +
| |   | |     | | | | | | |     | | |     |     | |     |     |     |             | |   | | | | | | |
+ +-+ + +-+-+ + +-+-+ + + + +-+ +-+ +-+-+ +-+ + + + +-+-+ +-+-+-+ + +-+ +-+-+-+ + + + +-+ + + + + + +
| |   |       |     | |       |     | |   | | | |     | | |   | | | | |   |     |   | |   | | | | | |
+ + +-+ +-+-+ + + + + +-+-+ +-+ + +-+ +-+ + +-+ + +-+-+ + +-+ + +-+ + +-+ + +-+ + + +-+-+-+-+-+-+ + +
|     |   |   | | |       | | | | | |   |   |   | | | |     | | | |   | | | |   | | | |   | |   | | |
+-+ +-+ + + + + + +-+ +-+-+ + +-+ + + + +-+-+ + + + + + + + + + + +-+ + +-+ + + +-+ + +-+ + + +-+ +-+
|   |   | | | | |   |   | |   |   |   | | |   | | | | | | |   |     | | | | | | |   |     |         |
+-+ +-+-+ + +-+ +-+ +-+ + + + +-+-+-+-+ + + + + +-+ + +-+ + + + + + + + + +-+-+-+ + +-+ + + + +-+-+-+
|     | | | |     | | | |   |   |   | |     | | | |       | |       |   | | | | | |       | |   |   |
+ + +-+ + +-+ + +-+-+ +-+ + + +-+-+ + + +-+-+-+ + + +-+ +-+-+ +-+ +-+ +-+ + + + +-+ +-+-+-+ +-+ +-+ +
| | | |   |   |   |     | | |     |   |   | |   |   | |   |     | |             | |       | |   |   |
+-+ + + + + + +-+ + +-+ + +-+-+-+-+-+ + + + + + + +-+ + + + + + +-+ +-+ +-+ + +-+ + + +-+ +-+-+-+ +-+
|   |   | | | | |   |   | |   |   |     | | | | |   | | | | | | | | |   | | |     | | |   | | |     |
+ + +-+-+ + +-+ +-+-+-+ +-+-+ + + +-+ +-+-+ +-+-+ +-+ +-+ + + + + +-+-+ + + + + +-+-+-+ + + + +-+-+ +
| | |   | | |       | |             |     |         | | | | | |       | |   | | |   |   | | |   |   |
+-+ + +-+-+ +-+-+-+ + +-+-+ + + + +-+-+ +-+-+-+-+ +-+ + +-+ + +-+ + + + +-+-+ + + +-+-+ +-+ + +-+-+ +
| |   | |     | |       | | | | |   | |     | |   |     |   | | | | |   | |   |     | |   |       | |
+ +-+ + + +-+ + + + +-+-+ + +-+-+ + + +-+ + + + +-+ +-+ +-+-+ + + + + +-+ + + + + + + + + +-+ + + + +
| |     | | |   | |   |     |     |     | |   | |     |   |     | | | |   | | | | |   | | | | | | | |
+ +-+ +-+ + + +-+-+-+ + + +-+-+ +-+ + + + + +-+-+ + +-+-+-+ +-+ +-+-+-+-+ + + +-+ +-+-+ +-+ + +-+ + +
| | |   |   | |         | | |   |   | | | |   | | |   | |   |             | | |   | |   | |   |     |
+ + + +-+-+ + + + +-+ + + + + + + + +-+ +-+ +-+ + +-+ + + +-+ + +-+ +-+-+ + +-+ + + + +-+ + + +-+ +-+
|   |   |   | | | | | | |   | | | | | | |       |   |   |   | | |   |   | | | | |   |   | | |   | | |
+ +-+-+ + + + + + + +-+-+-+-+-+-+ + + + +-+-+ +-+-+ +-+ + +-+ + + + + +-+-+ + + +-+-+-+-+ +-+-+-+ + +
|     | | | | | | |   |   |     | | | | | | | |   | | |   |   | | | | | | |   | | |     | |     |   |
+ +-+-+-+ + +-+-+-+ + +-+ + +-+ +-+ + + + + + + + + + + +-+ + + +-+-+ + + + + + + +-+ + + +-+-+ +-+ +
| |   | | | | |     | |   | |   |     | | | | | |     | | | | | |   |   |   | |       |   |         |
+ + +-+ + + + + +-+-+-+-+ + + + +-+-+ + + + + +-+ + +-+-+ + +-+ + +-+ + +-+ +-+-+-+-+ +-+-+-+ +-+ + +
| | | |   | | |   |   | |   | | | |   |     | |   |   |   |   |         |   | | |         | | | | | |
+ + + + + +-+ + +-+-+ + +-+ + + + + + +-+ +-+ + +-+-+-+-+ + +-+-+ + + +-+ +-+ + + + +-+-+-+ + + +-+ +
|   |   |   |   | |         | | |   | | |   | | |   | |   |   | | | | | |   |   | |   | | |     |   |
+ +-+ + +-+-+ +-+ +-+ + + +-+ + + +-+ + +-+-+ +-+-+ + +-+ + +-+ +-+ + + +-+ + + +-+ +-+ + +-+-+-+ + +
|   | | |   | | |     | |   | | |   | |     |   | |           | |   |     | | |         |       | | |
+-+ + +-+-+ + + +-+ +-+-+ + +-+-+-+-+ +-+ + + + + + + + + +-+ + +-+-+-+-+ +-+ +-+ + +-+ + + +-+-+ +-+
| |   |     | |         | | | |       | | |   |   | | | | | |   |         |   |   |   | | | | |   | |
+ +-+ +-+-+ + +-+-+-+ + +-+-+ +-+ +-+ + +-+ + + +-+ + +-+-+ +-+ + +-+ +-+-+-+ + +-+-+-+-+ + + + +-+ +
| | | |   |   |   | | | | |   |   |     | | | |   | |         | | |         | | | |   |   | |   |   |
+ + + +-+ +-+ + +-+ + +-+ +-+ +-+-+ +-+ + + + + +-+ +-+ + + +-+ +-+ + + + + + +-+ + + + +-+-+-+ + + +
| | |   |           |   | |   | | | |     | | |   | | | | | |     | | | | | |       | |     |     | |
+ + +-+ + +-+ + +-+-+ + + +-+ + + + +-+-+ + +-+ +-+ + +-+-+ + +-+-+ +-+ +-+ +-+-+ + +-+ + + +-+-+-+ +
| | | | | | | |   | | | |   | |     |   | | |     | | |   | | | | | | |   |   | | | |   | | |   |   |
+ + + + + + + +-+-+ + + + + + + + + + + +-+-+-+ + + + + + + +-+ + + + + + +-+-+ +-+ +-+-+ +-+-+ +-+ +
|   |   | | | | | |   | | | | | | |   |     | | | |     | | | |   | | | |     | | |   |   | |   |   |
+ + + + + + + + + + +-+ +-+ + + + +-+ +-+ +-+ + + +-+ + + +-+ + + + + + +-+-+ + + + +-+-+ + + +-+ + +
| | | | | |       |   | | |     | | | | |   |   |   | | |         | |   |       | |     |       | | |
+-+ +-+ + + + +-+-+ + + + +-+ + +-+ + + +-+-+ + +-+ +-+-+ +-+ + + +-+-+-+-+ + +-+ + +-+-+-+-+ + + +-+
|         | |       |       | |     |     |   |   |     |   | | |   |       |     |           |     |
+-+-+-+-+-+-+-+-+-+-+-+-+-+-+-+-+-+-+-+-+-+-+-+-+-+-+-+-+-+-+-+-+-+-+-+-+-+-+-+-+-+-+-+-+-+-+-+-+-+-+