+-+-+-+-+-+-+-+-+-+-+-+-+-+-+-+-+-+-+-+-+-+-+-+-+-+-+-+-+-+-+
|     | |     |   |   | |   |     |     | |     | |       | |
+ + +-+ + + + +-+ +-+ + + +-+-+ +-+ +-+-+ +-+-+ + + +-+-+ + +
| | |   | | |     |   | | | | | | |           | | | | |     |
+ + +-+ + +-+-+-+ + +-+ + + + + + +-+-+-+-+-+ + + + + + +-+-+
| |   |     |         |   |   | |           |   |   |   | | |
+ + +-+ +-+ + +-+ + + +-+ +-+ + + +-+-+ + +-+ + + + + + + + +
| |     |   | |   | |     | |   | | |   |   | |     | |   | |
+-+-+ +-+-+-+ +-+ + +-+ + + +-+ + + +-+ +-+ + + + +-+-+ +-+ +
|   | |   | |   | | | | |   |   |     |   | | | | | |       |
+ + + + + + +-+-+ +-+ +-+-+ +-+ +-+ + +-+ +-+-+-+ + +-+ +-+ +
| | |   | | |   | |       |     | | |   | |   | | | |   |   |
+ + + + +-+ +-+ + +-+ + +-+-+-+ + + + + + +-+ + + + +-+ + +-+
| |   | |   |   | |   |   | |   |   | | |     |     | | | | |
+ +-+ +-+-+ +-+ + + +-+-+ + + +-+-+ +-+ + +-+ +-+-+ + +-+ + +
|   | | |   |   | |   |   |   |   |   | |   |     | | |   | |
+-+ +-+ +-+ + + + + + + +-+ +-+ +-+ + + +-+ + +-+ + + +-+ + +
| |   |   |   |       | | |         | | | | | |   | | | |   |
+ +-+ +-+ +-+-+-+-+-+ + + + +-+ + + +-+ + + + +-+-+ + + +-+ +
|                   | |   |   | | |   | |   |             | |
+-+-+-+-+-+-+-+-+-+-+-+-+-+-+-+-+-+-+-+-+-+-+-+-+-+-+-+-+-+-+