+-+-+-+-+-+-+-+-+-+-+-+-+-+-+-+-+-+-+-+-+-+-+-+-+-+-+-+-+-+-+-+-+-+-+-+-+-+-+-+-+-+-+-+-+-+-+-+-+-+-+-+-+-+-+-+-+-+-+-+-+
| |   |   | |   | | | | |         |     | | | | | |     |           |             | | | | |     | | |           |   |   |
+ +-+ +-+ + +-+ + + + + +-+-+-+ + +-+-+ + + + + + + + + +-+ +-+-+ +-+ + +-+ +-+ +-+ + + + +-+-+ + + + + + +-+ +-+ +-+ + +
|     |           |           | |     | |       | | | |   |   | |       | |   |       |   |   | |               |   | | |
+ +-+-+-+ + +-+-+-+ +-+-+-+-+ +-+ +-+-+ + +-+-+-+ + + + +-+ +-+ + + + +-+ +-+ + + +-+-+ +-+ +-+ + + +-+ +-+-+-+-+-+ + + +
| | | |   | |   |     |   | | |   | | | | |   | |   | | |     |   | | | |   | | | |     |                 |     | | | | |
+ + + +-+-+ + + +-+ +-+ +-+ + + + + + + + +-+ + + +-+-+ + + +-+ +-+-+ + + + + +-+ +-+-+ + +-+ +-+-+-+-+-+ + + + + + + +-+
| | |   | |     |           | | | |   |   | | |   | | |         | |   | | |   | | |         |     |           | | |     |
+ + +-+ + +-+ + +-+-+-+-+-+ + + +-+ +-+ + + + + + + + +-+-+ +-+-+ +-+ + + +-+ + + +-+ +-+ + + + +-+ +-+ + + +-+-+ +-+ + +
| |   | | | | | | |     | | | |   | |   | |     | | | |   | |     | |   |     | | |   | | | | | |   |   | | |   | | | | |
+ +-+ + + + + + + + + + + +-+ + +-+ + + +-+ + +-+ + + + + + +-+-+ + +-+ +-+ +-+ + + + + +-+ + +-+-+ + + + + + + + + +-+ +
| |     |     |       | |   | | |     |   | |   |   | | | | | |   | | |   | | |   | | |   | | |     | | | | | | |     | |
+ +-+ +-+ + + +-+-+ +-+-+ +-+ + + +-+-+ + +-+-+ + +-+ + +-+ + +-+ + + +-+ +-+ + + +-+ +-+ +-+ +-+-+-+ +-+-+-+-+ +-+-+ + +
| | |     | | |   | |   |   |     |     |   |   |     |     |     |           | |   |     | |   | |         | |   |   | |
+ + +-+-+-+ + +-+ + +-+ + + + + + + +-+ + + +-+ + + +-+-+ +-+-+ + + + +-+ + + +-+ + +-+-+ + +-+ + +-+ + + + + +-+ + +-+ +
| | | |     | |     |     |   | | | |   | | |   | |   |       | | | |   | | |   | | | | | |   | |     | | | | |   |     |
+ + + +-+ +-+-+-+ + + + +-+ +-+ + + + +-+ +-+-+ +-+ +-+ + + +-+ +-+ + + + + +-+-+ + + + + + +-+ +-+ +-+-+ + + + +-+-+ + +
|   |           | |     | | |   | | | | | | | |   | |   | |     |   | | | | | | | | | |   |   |   |   |   |   | |   | | |
+-+ +-+ + +-+-+ + + +-+ + + + +-+ + + + + + + + +-+ + +-+ +-+ +-+-+-+ + +-+-+ + + + + + + + + + +-+ +-+ + +-+-+ +-+ +-+ +
| | | | |   |   | |   | | |   | | | | | |   | |   | | |   | | | |     |         | |   | |     |   | | | | | | | | |   | |
+ + + +-+ + +-+ + + + +-+ +-+ + + +-+-+ + + + + + +-+-+-+ + + + + + + +-+ + + +-+ +-+-+ + + +-+ +-+ + + +-+ + + + + +-+ +
|       | | | | | | | |         | | |   | | |   | | | |     | |   | | | | | |   |   |   | |   | |     |     | |   | | | |
+ + + + + +-+ + +-+-+-+ + +-+ +-+ + + + + +-+ +-+-+ + + +-+-+-+-+ +-+-+ +-+ + + + + + +-+ +-+-+-+-+-+ +-+-+ + + + + + + +
| | | | |     |   |     |   |   |   | | |         |   |     |   | | | | | | | | | | | | |       |         |   | |       |
+ + + +-+ +-+-+ + + + + +-+ + +-+-+ + +-+-+-+ +-+-+ +-+-+ + + +-+ + + + + + + +-+-+-+ + +-+-+ + + +-+ + + +-+-+-+ + +-+-+
| | |   | |   | | | | | |   | | | | |   | |   | | | |   | |     |     |   | | | |   | | | | | | |   | | |   | |   |   | |
+ + +-+ + +-+ +-+-+ +-+ +-+ + + + + +-+ + + +-+ + + +-+ +-+ +-+-+ +-+ + + + + + + +-+ + + + + + +-+ +-+-+-+-+ + +-+-+-+ +
| | |     | | |     |   | | |   |   | | | | | | | | |     | | |   | | | | | |       | | |     | | |   | | |     |   |   |
+ +-+-+ +-+ + + +-+-+ + + + +-+ + +-+ + + + + + + + +-+ + + + + + + + +-+ +-+ +-+-+ + + + +-+-+-+ +-+ + + + + +-+ + +-+ +
| | | | | |   | |   | |   | |   | | |   |   |   |     | | | |   |   | |       |         | |   |         | | |     | | | |
+ + + + + + + + +-+ + + +-+ +-+-+ + + +-+ +-+-+ +-+-+ + +-+ + + + +-+ + +-+ +-+-+-+ +-+-+ + + +-+ + +-+-+ +-+-+ +-+-+ + +
| |           |     | |   |     | |     | |       | |     | | | |   | | |     | | |     |   | |   | |         | |   |   |
+ + + + +-+-+ + +-+ + +-+-+ +-+ + + +-+ + +-+ +-+-+ +-+-+ + +-+-+-+-+ +-+ +-+ + + + +-+-+-+ + +-+ +-+-+ +-+-+-+ +-+ +-+ +
| | | | | | | |   | | | |   |   | | |     | | | | | |       | |   | | |     | |   |       | |   | |   | | |         |   |
+ + +-+ + + +-+ +-+ +-+ +-+ + + +-+ +-+ +-+ + + + + + +-+ + + +-+ + + + +-+-+-+-+ +-+ + +-+ + +-+ +-+ + + + + + +-+-+ +-+
| |   |   | | | | | |   |   | | |   | | | | | | | |     | | |       | |   | | |   | | |   | | |   |   |   | | |   |     |
+-+ + +-+ + + + + + + +-+ + + + +-+-+ + + + + + + +-+ +-+ + +-+-+-+ +-+ +-+ + + + + + +-+ + + +-+-+-+ +-+ +-+-+-+ +-+ +-+
|   | | | |     |     | | | | |   | | |   |   |         | | | | | | |       | | |     |   | | | |   | |     |     | |   |
+ +-+-+ +-+-+ + + +-+-+ +-+-+-+ + + + +-+ + +-+ + + +-+ +-+ + + + + +-+ + + + +-+-+-+ +-+ + + + +-+ + +-+-+ +-+-+ + +-+ +
|       | |   | |             | | |     | | | | | |   | | | |   |   |   | |   |     | |   | | | |   | | |   |           |
+-+-+ + + + + +-+ + + + +-+-+-+-+-+ + + + + + + +-+ +-+-+ + + +-+-+ + +-+-+ + + + + +-+-+-+-+ + +-+ + + + + +-+ + +-+-+ +
|     |   | | |   | | |     | | | | | | |     |   | | | | | |     | |     | | | | | | | |   |     | |   | |   | | | | | |
+-+-+ + +-+ +-+ + +-+ +-+ + + + + + +-+-+-+-+-+ +-+-+ + + + +-+-+ + +-+-+-+ + +-+-+ + + +-+ + + +-+ + +-+-+ + + +-+ + + +
| |   |   | |   |   | |   | | |     | |   | | |           |   | | |   |     | | | | |     | | | | |     | | | | |     | |
+ +-+-+-+-+ + + +-+ +-+ + + + +-+ +-+ +-+ + + +-+ + + +-+ + + + + +-+ +-+-+-+ + + + + +-+ + + +-+ + + + + +-+ + +-+-+ + +
|   |       | | |     | | |       |               | |   | | | |   | |   |   |     | | | |   |   | | | | |   | |     | | |
+ +-+-+ +-+ + + +-+-+-+ + + + + +-+-+-+ +-+ +-+-+-+ + +-+ +-+-+-+ + +-+ +-+ +-+-+ + + + + +-+ +-+ +-+-+ + + + +-+-+ + + +
| | | |   | | |   | | | | | | | |   | |   |     |   |   |   | |   |   | |     | | | |   | | |   | | | | | | |   | | | | |
+ + + +-+ +-+-+-+ + + + + +-+ + + + + +-+ +-+-+-+-+ +-+-+-+ + +-+ +-+ + +-+ +-+ + + +-+-+ + +-+ + + + + + + + + + + + + +
|     | | |     |   | | | | | | | | |     | | | | |       | | | |   | |   | | |   | | |     |     | |         | |   |   |
+ +-+-+ + +-+ + + +-+ + + + + +-+ + +-+ + + + + + + + + +-+-+ + + + + + +-+ + +-+ + + + +-+ + +-+ + + +-+ + + +-+ + + +-+
| | | |         |   |   |   |   | |     | |     |   | | | | |     |   |   | |   |   |     |   | |   | | | | |   | | |   |
+ + + + +-+-+-+-+ +-+-+-+-+ + + + + + + + + +-+-+-+-+ + + + +-+ + +-+ + +-+ + +-+-+-+ +-+-+-+ + + +-+ + +-+-+-+ + + + +-+
|         | |   | |   | |   | | | | | | |           | | | |   | |   | |   | | |   |       |     | | |   | | |     | |   |
+ +-+ + +-+ +-+ + +-+ + +-+-+-+-+ +-+-+-+ + +-+ +-+ +-+ + + + + +-+ + + + + + + + + + + + +-+ + + + + + + + + + +-+-+ + +
| |   | | |     | | | |     | |       |   |   |   |   | | | |     | |   | |       | | | |   | | | |   | | | | |   |   | |
+-+ + +-+ + + + + + + +-+-+ + +-+-+-+-+ + + +-+ +-+-+ +-+ + +-+-+ + + + +-+-+ +-+ + +-+-+ +-+-+-+-+ +-+ + + + + + +-+ +-+
| | |           |   | |     |         | | |   |     | | | | | | | | | |             | |     | |     | | | |   | |   |   |
+ +-+-+-+ + +-+ +-+-+ +-+ + +-+-+-+-+ + +-+-+-+ + +-+-+ + + + + + + + + + +-+ + +-+-+ +-+-+ + +-+-+ + + + +-+ + + +-+ +-+
|         | |                         |       | |     |     |     | | | |   | |         |                   | | |       |
+-+-+-+-+-+-+-+-+-+-+-+-+-+-+-+-+-+-+-+-+-+-+-+-+-+-+-+-+-+-+-+-+-+-+-+-+-+-+-+-+-+-+-+-+-+-+-+-+-+-+-+-+-+-+-+-+-+-+-+-+