+-+-+-+-+-+-+-+-+-+-+-+-+-+-+-+-+-+-+-+-+
|   |         | |       |   | | |     | |
+-+ +-+-+ +-+-+ + + +-+-+ + + + +-+-+ + +
|       | | | | | | | |   |   |       | |
+-+ +-+ + + + + + + + +-+-+-+ +-+ +-+ + +
|     |   | |         |       | | | |   |
+-+ + +-+ + + + + +-+-+-+ + + + + + +-+ +
|   |   | |   | | | |     | |   | |     |
+-+-+ +-+-+ +-+ +-+ + +-+-+ + + +-+ + +-+
| |       | |           | | | |   | |   |
+ +-+-+-+ + + +-+ + + +-+ + +-+ +-+ + +-+
| | | | |   | |   | | | | |   | |   |   |
+ + + + +-+ + + +-+ +-+ + + + + +-+-+ +-+
| | |   |   | | |     | |   | |   |   | |
+ + +-+ +-+-+-+ + +-+-+ +-+ + +-+ +-+ + +
| | |   |       | | | | | | | | |   | | |
+ + + + + +-+-+ +-+ + + + +-+ + +-+ + + +
| | | | |     |   | |   | |   |     | | |
+ + +-+ + + + +-+-+ + +-+ + +-+ + +-+ + +
|   | |   | | | | | |     |   | | |     |
+-+ + +-+-+ + + + + +-+ +-+ +-+ +-+ + +-+
|   |   |   |       |   |   | | | | |   |
+-+ + + +-+ +-+ + +-+ +-+-+ + + + +-+ +-+
|   | | | | | | |         |   |         |
+-+ +-+ + + + +-+-+ +-+ +-+-+ +-+-+-+ +-+
| |         | | | | |     | |   | |   | |
+ +-+ + + + + + + + +-+ +-+ + + + + + + +
|     | | |   | |     |   | | | |   |   |
+ + + +-+-+ + + + + +-+-+ + +-+ + +-+-+ +
| | |     | |   | |   |       | |     | |
+ + + +-+ +-+ +-+ + + + +-+ +-+ +-+ + + +
| | |   | |     | | | | |   |   | | | | |
+ +-+-+ + +-+-+ +-+-+ +-+-+ +-+ + + +-+ +
|     | | | |   | | | | |     | | |   | |
+-+ + + +-+ +-+ + + + + +-+-+ +-+ + + + +
| | | | |     |   |   |     |   | | | | |
+ +-+ + + + +-+ +-+-+ +-+-+ + +-+ + +-+ +
|   | |       |     | | |   |   | | | | |
+-+ + + + + +-+-+-+ +-+ + +-+-+ + + + + +
|     | | |       |         |     | |   |
+-+-+-+-+-+-+-+-+-+-+-+-+-+-+-+-+-+-+-+-+